日期,融资买入额(元),融资余额(元),融券卖出量,融券余量,融券余额(元),融资融券余额(元)
2017-07-12,26963679,757818301,22000,22025,288528,758106829
2017-07-13,29430238,757804462,63400,63425,827696,758632158
2017-07-14,36635036,762874181,7000,67225,845691,763719872
2017-07-17,44643188,747647507,48200,48525,549303,748196810
2017-07-18,21815005,743003439,21900,36925,421684,743425123
2017-07-19,28161862,741781607,500,30525,360500,742142107
2017-07-20,47401995,739639873,149450,149475,1856480,741496353
2017-07-21,28667266,740882785,3100,100125,1225530,742108315
2017-07-24,20343816,734290848,30000,34425,423772,734714620
2017-07-25,18452165,733971073,2300,5425,66999,734038072
2017-07-26,29024263,739910859,174800,178025,2228873,742139732
2017-07-27,37557068,743101344,4900,94925,1183715,744285059
2017-07-28,20219602,743287731,0,60025,745511,744033242
2017-07-31,21976341,744644394,7000,67025,830440,745474834
2017-08-01,41937571,733977082,115900,182925,2334123,736311205
2017-08-02,42627459,740729477,40000,143525,1825638,742555115
2017-08-03,23949230,748547669,0,83525,1059932,749607601
2017-08-04,30426840,732137177,128950,152475,1980650,734117827
2017-08-07,28586483,731336837,0,20000,258000,731594837
2017-08-08,35540360,727318040,110450,130450,1707591,729025631
2017-08-09,42617388,730618629,22500,102500,1315075,731933704
2017-08-10,34354463,739964639,30500,110500,1400035,741364674
2017-08-11,28928916,737938639,0,30000,363900,738302539
2017-08-14,22036494,736477612,59950,79950,1006571,737484183
2017-08-15,15795909,736856109,50,30000,376500,737232609
2017-08-16,64382372,732758510,199500,229500,3169395,735927905
2017-08-17,98561956,712461227,10000,40050,557897,713019124
2017-08-18,57748070,727627475,0,10050,137283,727764758
2017-08-21,82056434,737973662,232450,242500,3411975,741385637
2017-08-22,48470523,752114003,10400,100450,1384201,753498204
2017-08-23,31886204,757673324,0,90050,1223780,758897104
2017-08-24,26855841,752747134,20000,50050,686186,753433320
2017-08-25,37078647,750433344,50000,80050,1108693,751542037
2017-08-28,74153822,763148180,162500,212550,2999081,766147261
2017-08-29,56504432,772450406,4000,114050,1577312,774027718
2017-08-30,67568510,770484694,92500,186550,2630355,773115049
2017-08-31,37151546,772900712,0,94050,1319522,774220234
2017-09-01,49180676,773347833,0,94050,1311998,774659831
2017-09-04,94114426,759833213,120000,214050,3122990,762956203
2017-09-05,141307443,755257212,32500,136550,2082388,757339600
2017-09-06,131914054,768726254,112700,229250,3567130,772293384
2017-09-07,156335179,796938291,20000,134050,2054987,798993278
2017-09-08,194517788,814948669,92900,186950,3054763,818003432
2017-09-11,109068934,828970550,0,134450,2163301,831133851
2017-09-12,99730090,829184264,0,134450,2135066,831319330
2017-09-13,76865283,828180221,18000,121850,1956911,830137132
2017-09-14,86209604,838531142,2000,123850,1940730,840471872
2017-09-15,50742937,822051842,109950,206200,3249712,825301554
2017-09-18,78670355,791897174,42500,156550,2478187,794375361
2017-09-19,84330040,798456640,62800,156850,2357456,800814096
2017-09-20,52189865,804455106,40000,124050,1879358,806334464
2017-09-21,40618488,800672813,13400,117450,1758227,802431040
2017-09-22,34522197,803762698,6700,33750,502200,804264898
2017-09-25,39107341,803892558,65050,98800,1414816,805307374
2017-09-26,17442162,801103414,0,55950,808478,801911892
2017-09-27,25090292,804634663,0,55950,809037,805443700
2017-09-28,40392295,808254696,142500,198450,2931107,811185803
2017-09-29,19412963,789280141,0,65950,977379,790257520
2017-10-09,45038246,794160190,31500,64550,967605,795127795
2017-10-10,44011618,804617422,80100,94650,1424483,806041905
2017-10-11,57667392,821016339,0,53050,786201,821802540
2017-10-12,25866011,828521330,20000,73050,1081140,829602470
2017-10-13,19834308,829532663,4000,77050,1146504,830679167
2017-10-16,40763624,825158786,60400,137450,1932547,827091333
2017-10-17,26517945,825728043,72480,157330,2243526,827971569
2017-10-18,20186599,823142662,1400,86250,1212675,824355337
2017-10-19,33787007,825503176,9000,83850,1132814,826635990
2017-10-20,17156514,824864347,61700,85550,1189145,826053492
2017-10-23,15305136,824782574,34100,95650,1341013,826123587
2017-10-24,15751371,825967210,0,30050,416193,826383403
2017-10-25,22311806,831362467,90200,120250,1688310,833050777
2017-10-26,25369099,833251156,0,32550,458630,833709786
2017-10-27,15710111,824351304,0,10050,140198,824491502
2017-10-30,29877900,819190454,10400,20450,270963,819461417
2017-10-31,13919861,816614889,20000,30050,401168,817016057
2017-11-01,28654862,802171990,159940,169990,2339062,804511052
2017-11-02,19762599,804435391,10400,80450,1090902,805526293
2017-11-03,36272128,808209920,82432,162882,2260802,810470722
2017-11-06,32899961,783485816,80000,202432,2906924,786392740
2017-11-07,28154059,782618926,10000,110000,1580700,784199626
2017-11-08,47237254,792045681,30000,130000,1873300,793918981
2017-11-09,42229239,785109036,40500,140500,2048490,787157526
2017-11-10,60487393,783515220,102500,172500,2587500,786102720
2017-11-13,69497651,815274782,0,70000,1033200,816307982
2017-11-14,47832500,823962672,41350,111350,1652434,825615106
2017-11-15,38750314,822902347,0,99950,1476262,824378609
2017-11-16,42010076,811437754,8400,108350,1539654,812977408
2017-11-17,52464864,807374796,14100,92500,1290375,808665171
2017-11-20,23719054,802983064,0,70000,959700,803942764
2017-11-21,30334986,795697732,130500,200500,2829055,798526787
2017-11-22,32435366,798564801,0,70000,989800,799554601
2017-11-23,69550577,794676106,162450,232450,3314737,797990843
2017-11-24,95764629,809914714,20450,110450,1670004,811584718
2017-11-27,53792916,806650279,70000,130000,1911000,808561279
2017-11-28,102362790,840215933,123000,213000,3297240,843513173
2017-11-29,81902506,820814407,29950,110450,1725229,822539636
2017-11-30,96426916,805919316,102500,183000,2712060,808631376
2017-12-01,48971811,819199235,30000,130000,1937000,821136235
2017-12-04,65014363,811933460,117999,187999,2786145,814719605
2017-12-05,64645462,786530978,30000,100000,1340000,787870978
2017-12-06,36240121,779255261,30000,130000,1782300,781037561
2017-12-07,38711179,787136343,77500,177500,2461925,789598268
2017-12-08,35256577,788162020,40000,110000,1552100,789714120
2017-12-11,28017792,789591428,20000,90000,1270800,790862228
2017-12-12,35822733,794647049,65000,135000,1892700,796539749
2017-12-13,44622733,784564354,125000,207500,2921600,787485954
2017-12-14,65872234,794703848,52500,122500,1799525,796503373
2017-12-15,56584076,786436923,115000,205000,3031950,789468873
2017-12-18,46416081,790901206,0,100000,1484000,792385206
2017-12-19,30047737,795562200,32500,132500,1961000,797523200
2017-12-20,63270944,804009764,97500,190000,2812000,806821764
2017-12-21,59031901,810948190,60000,157500,2356200,813304390
2017-12-22,51856363,805198615,20000,120000,1773600,806972215
2017-12-25,59723374,792689196,32500,152500,2119750,794808946
2017-12-26,26790766,791391638,30000,130000,1838200,793229838
2017-12-27,24252520,787431821,0,100000,1415000,788846821
2017-12-28,64654196,778286931,90000,130000,1908400,780195331
2017-12-29,80077871,775873130,130000,170000,2595900,778469030
2018-01-02,73506166,777624175,10000,100000,1532000,779156175
2018-01-03,77639180,768914798,112500,182500,2841525,771756323
2018-01-04,105696123,792077586,40000,110000,1718200,793795786
2018-01-05,89621976,794484706,80000,165000,2583900,797068606
2018-01-08,62874883,796908756,10000,95000,1462050,798370806
2018-01-09,118413677,823143946,147500,242500,3843625,826987571
2018-01-10,118311043,841107887,0,120000,1948800,843056687
2018-01-11,100539911,863990343,40000,140000,2258200,866248543
2018-01-12,64245646,849646335,12500,52500,825825,850472160
2018-01-15,155948816,863312544,202450,242450,4048915,867361459
2018-01-16,101916981,851734475,12500,82500,1305150,853039625
2018-01-17,103077209,844594336,75000,115000,1773300,846367636
2018-01-18,58754916,847212717,12500,82500,1258950,848471667
2018-01-19,78085988,828556583,155000,195000,3100500,831657083
2018-01-22,59157970,842293278,0,95000,1498150,843791428
2018-01-23,60163444,843296926,82500,157500,2501100,845798026
2018-01-24,64144469,850210132,0,75000,1196250,851406382
2018-01-25,84742630,855182843,122500,162500,2629250,857812093
2018-01-26,49013272,834806874,0,40000,635600,835442474
2018-01-29,75096425,846524110,0,40000,602800,847126910
2018-01-30,35869507,842154330,0,40000,604000,842758330
2018-01-31,43286050,834560577,20000,60000,875400,835435977
2018-02-01,34992031,815177165,10000,70000,970200,816147365
2018-02-02,32656913,811046568,0,50000,705000,811751568
2018-02-05,19832207,809099886,8000,58000,810840,809910726
2018-02-06,38465341,785253535,92500,132500,1666850,786920385
2018-02-07,41147767,771757415,10000,70000,863800,772621215
2018-02-08,13580229,768835557,0,60000,743400,769578957
2018-02-09,34469984,749020952,131000,191000,2481090,751502042
2018-02-12,66691121,750307329,0,120000,1714800,752022129
2018-02-13,50774319,751476488,0,120000,1654800,753131288
2018-02-14,31091125,736137385,30000,70000,982800,737120185
2018-02-22,57891640,748617719,72500,112500,1663875,750281594
2018-02-23,49719478,750690356,0,40000,584000,751274356
2018-02-26,44895173,746118076,90000,130000,1917500,748035576
2018-02-27,58691207,757112331,70000,110000,1626900,758739231
2018-02-28,42819056,748041135,63003,143003,2142185,750183320
2018-03-01,53212868,753431908,50600,120600,1836738,755268646
2018-03-02,47681008,762088603,28800,98800,1473108,763561711
2018-03-05,58743911,769448510,151700,220500,3424365,772872875
2018-03-06,57149283,770977074,0,80000,1243200,772220274
2018-03-07,85764051,779738650,98950,168950,2647447,782386097
2018-03-08,53275733,775789720,0,70000,1103200,776892920
2018-03-09,78601444,782277212,140000,180000,2889000,785166212
2018-03-12,78084987,777452035,41000,81000,1312200,778764235
2018-03-13,83048179,778617371,152500,193500,3183075,781800446
2018-03-14,89714383,791102168,0,81000,1283850,792386018
2018-03-15,58768732,796027603,30000,91000,1447810,797475413
2018-03-16,113298091,806463412,161500,192500,3205125,809668537
2018-03-19,125358354,816116533,60000,122500,2021250,818137783
2018-03-20,66637905,803623077,70000,110000,1819400,805442477
2018-03-21,109718556,816684566,122500,172500,2834175,819518741
2018-03-22,106253832,818026150,40000,102500,1599000,819625150
2018-03-23,76994542,789982526,120000,150000,2227500,792210026
2018-03-26,78724954,782271026,77500,157500,2238075,784509101
2018-03-27,80374716,785638218,60000,157500,2190825,787829043
2018-03-28,52423712,786455339,17800,105300,1411020,787866359
2018-03-29,34647752,782294973,112113,207413,2816669,785111642
2018-03-30,42230772,777951478,0,87500,1190875,779142353
2018-04-02,38227949,772854238,60000,147500,2025175,774879413
2018-04-03,28611521,759126006,45000,132500,1767550,760893556
2018-04-04,26948423,754564654,5000,97500,1301625,755866279
2018-04-09,39078344,750715492,149700,214700,2930655,753646147
2018-04-10,42817513,749085000,0,105000,1453200,750538200
2018-04-11,28870653,746316895,0,65000,897000,747213895
2018-04-12,59299387,749692579,202500,257500,3602425,753295004
2018-04-13,52116176,748604938,10000,127500,1790100,750395038
2018-04-16,43294582,754042469,9500,87000,1162320,755204789
2018-04-17,28790525,737687866,20000,107000,1366390,739054256
2018-04-18,23626819,728825685,100000,207000,2707560,731533245
2018-04-19,22163905,723633907,0,157000,2037860,725671767
2018-04-20,24543963,712893706,500,127500,1565700,714459406
2018-04-23,11089295,706516940,0,118000,1463200,707980140
2018-04-24,19886947,709119783,30000,123000,1569480,710689263
2018-04-25,37864142,715151883,60000,100500,1307505,716459388
2018-04-26,20914297,713770237,22500,93000,1168080,714938317
2018-04-27,22752576,706330103,30000,70500,902400,707232503
2018-05-02,14514979,705202992,0,70500,891120,706094112
2018-05-03,20284461,703593962,30000,100500,1308510,704902472
2018-05-04,24034946,711078493,0,70500,902400,711980893
2018-05-07,21507065,712332910,1000,61500,794580,713127490
2018-05-08,16668370,709384133,0,61500,795810,710179943
2018-05-09,21333712,707877375,0,61500,779820,708657195
2018-05-10,15400732,701481658,0,61500,780435,702262093
2018-05-11,16393199,702905929,0,61500,771825,703677754
2018-05-14,14490627,700229861,0,61500,765675,700995536
2018-05-15,12391686,702304198,0,61500,769980,703074178
2018-05-16,13437654,698014850,0,61500,754605,698769455
2018-05-17,10142886,696494091,0,61500,757065,697251156
2018-05-18,15823483,698162299,0,61500,772440,698934739
2018-05-21,21148360,703758367,0,61500,774285,704532652
2018-05-22,15807986,704140031,47900,79400,1011556,705151587
2018-05-23,15606998,702315763,0,49400,612560,702928323
2018-05-24,13362726,700783817,0,49400,609596,701393413
2018-05-25,10020390,691272016,0,49400,596752,691868768
2018-05-28,17520920,683143336,37400,56800,663992,683807328
2018-05-29,33899806,681863530,191100,217900,2691065,684554595
2018-05-30,20375234,679257279,0,94400,1092208,680349487
2018-05-31,13721809,679446048,0,44400,519924,679965972
2018-06-01,27082872,681136209,102500,146900,1787773,682923982
2018-06-04,16417963,681564190,0,44400,542124,682106314
2018-06-05,17531203,680424349,5000,49400,613548,681037897
2018-06-06,30863037,674207116,20000,69400,891096,675098212
2018-06-07,21511730,674887616,0,59400,752004,675639620
2018-06-08,22378046,674001110,30000,89400,1130910,675132020
2018-06-11,13374674,676903767,22500,81400,1011802,677915569
2018-06-12,21219268,678509627,20200,59100,752343,679261970
2018-06-13,18349586,677584282,0,48900,597558,678181840
2018-06-14,21752894,682824916,185700,229600,2847040,685671956
2018-06-15,21392108,672904979,11700,65900,786846,673691825
2018-06-19,25308786,654494798,70500,129400,1391050,655885848
2018-06-20,17437705,641445229,7000,98400,1047960,642493189
2018-06-21,19183615,618189714,138000,226900,2175971,620365685
2018-06-22,17307173,600103804,19500,113900,1074077,601177881
2018-06-25,11036254,595988028,5000,118900,1084368,597072396
2018-06-26,12286580,593919361,5000,113900,1064965,594984326
2018-06-27,10802673,591797538,5000,118900,1099825,592897363
2018-06-28,17152067,593845573,70000,183900,1715787,595561360
2018-06-29,14903982,588530883,5000,113900,1088884,589619767
2018-07-02,15943148,591240863,40000,138900,1283436,592524299
2018-07-03,11444871,590643837,10000,108900,1031283,591675120
2018-07-04,15120017,591857751,0,108900,995346,592853097
2018-07-05,14238352,579220566,0,96000,834240,580054806
2018-07-06,14549519,572474947,5000,101000,901930,573376877
2018-07-09,11124629,569922757,40000,141000,1298610,571221367
2018-07-10,9461448,566556481,42900,153900,1432809,567989290
2018-07-11,13343468,563327475,0,123900,1111383,564438858
2018-07-12,16440644,568378520,0,93900,870453,569248973
2018-07-13,14354428,561855661,0,93900,854490,562710151
2018-07-16,6449300,560565910,0,78900,721146,561287056
2018-07-17,8754636,559835081,0,78900,724302,560559383
2018-07-18,11098171,559961599,0,78900,716412,560678011
2018-07-19,11927762,558669549,0,78900,706944,559376493
2018-07-20,21663394,565773082,27500,101400,933894,566706976
2018-07-23,36559609,565354540,130000,208900,2116157,567470697
2018-07-24,67560092,563266244,57500,156400,1635944,564902188
2018-07-25,53889758,576753502,80000,138900,1473729,578227231
2018-07-26,41457660,581425447,117500,191400,2028840,583454287
2018-07-27,39381530,574457133,30000,143900,1542608,575999741
2018-07-30,34284907,572775525,5000,113900,1194811,573970336
2018-07-31,33245960,578128821,87500,196400,2081840,580210661
2018-08-01,28670116,582884135,0,103900,1069131,583953266
2018-08-02,28922981,584779711,107500,166400,1728896,586508607
2018-08-03,21771375,587281528,0,133900,1336322,588617850
2018-08-06,19179369,586885398,20000,108900,1096623,587982021
2018-08-07,32767090,589210625,147447,211347,2204349,591414974
2018-08-08,24664389,588995715,0,128900,1312202,590307917
2018-08-09,40041091,598496166,125000,248900,2628384,601124550
2018-08-10,30794381,593844856,0,118900,1253206,595098062
2018-08-13,26790514,593797079,0,118900,1234182,595031261
2018-08-14,51213494,597797401,167500,251400,2730204,600527605
2018-08-15,33031503,603914872,5000,151900,1596469,605511341
2018-08-16,26833537,606228013,0,109400,1113692,607341705
2018-08-17,23619856,601062403,117000,176400,1793988,602856391
2018-08-20,31663620,593981414,50900,169800,1608006,595589420
2018-08-21,19785423,596559735,27500,141400,1348956,597908691
2018-08-22,14455920,591255460,30000,171400,1590592,592846052
2018-08-23,17614369,593001814,5000,118900,1123605,594125419
2018-08-24,9936781,588306437,5000,123900,1163421,589469858
2018-08-27,22451725,590373037,87450,211350,2026847,592399884
2018-08-28,14542748,590629278,0,101400,973440,591602718
2018-08-29,11946603,590445794,0,78900,747972,591193766
2018-08-30,16279603,589549951,5000,78900,718779,590268730
2018-08-31,5583755,586506610,0,78900,721935,587228545
2018-09-03,8971143,587748384,39977,118877,1103179,588851563
2018-09-04,11934555,587051082,5000,83900,786143,587837225
2018-09-05,13845829,588224344,0,83900,767685,588992029
2018-09-06,10869457,589674159,0,78900,716412,590390571
2018-09-07,12283410,586797107,10000,88900,823214,587620321
2018-09-10,11323935,584610724,0,88900,804545,585415269
2018-09-11,7913077,583753482,15000,103900,934061,584687543
2018-09-12,6483921,580694035,70000,168900,1521789,582215824
2018-09-13,11681608,582972308,0,88900,816102,583788410
2018-09-14,10364734,582793276,0,88900,802767,583596043
2018-09-17,10941674,574681763,157450,246350,2256566,576938329
2018-09-18,18190601,574556313,0,123900,1158465,575714778
2018-09-19,19089103,575422976,0,93900,882660,576305636
2018-09-20,17933399,567293395,152500,246400,2380224,569673619
2018-09-21,23259639,565918833,0,93900,915525,566834358
2018-09-25,18260114,567851895,0,93900,897684,568749579
2018-09-26,17994853,568847304,70000,163900,1565245,570412549
2018-09-27,11420087,561679680,0,163900,1553772,563233452
2018-09-28,12249955,550143994,0,93900,891111,551035105
2018-10-08,17516977,552742187,0,88900,793877,553536064
2018-10-09,7034857,551188118,0,88900,808990,551997108
2018-10-10,6311070,549270723,0,88900,808101,550078824
2018-10-11,14536199,545418640,0,88900,727202,546145842
2018-10-12,12809273,527686065,47100,116000,905960,528592025
2018-10-15,11597799,517220496,34500,103400,763092,517983588
2018-10-16,7762680,500015577,0,80900,577626,500593203
2018-10-17,16291005,498003554,72929,153829,1132181,499135735
2018-10-18,10651986,498157403,0,123900,873495,499030898
2018-10-19,9275545,495922586,2000,125900,915293,496837879
2018-10-22,30473430,499316890,132931,228900,1831200,501148090
2018-10-23,21555638,499271795,0,178900,1382897,500654692
2018-10-24,21128752,493992424,30000,168900,1315731,495308155
2018-10-25,17447315,492402000,92500,231400,1846572,494248572
2018-10-26,17243228,496285454,0,138900,1086198,497371652
2018-10-29,6927845,494967458,0,138900,1062585,496030043
2018-10-30,13230269,490165661,0,88900,703199,490868860
2018-10-31,16817357,493767707,0,88900,703199,494470906
2018-11-01,19327722,491255902,0,73900,585288,491841190
2018-11-02,25689947,489844381,82500,156400,1362244,491206625
2018-11-05,67254304,501671673,148000,259400,2334600,504006273
2018-11-06,48178981,498748531,45000,261400,2331688,501080219
2018-11-07,31668884,490306527,30000,261400,2383968,492690495
2018-11-08,48782598,501205767,43000,289400,2676950,503882717
2018-11-09,47605218,502555225,15000,261400,2436248,504991473
2018-11-12,38246323,504967854,0,261400,2496370,507464224
2018-11-13,71906380,501555174,39100,300500,2890810,504445984
2018-11-14,48931973,507828371,3900,248300,2316639,510145010
2018-11-15,35639990,501234684,56079,264979,2533199,503767883
2018-11-16,102736946,534683051,39400,259400,2619940,537302991
2018-11-19,51504090,541933778,30000,211000,2114220,544047998
2018-11-20,58591895,536227219,90500,301500,2984850,539212069
2018-11-21,46076023,544008725,0,258500,2621190,546629915
2018-11-22,90427968,563172235,52985,311485,3329775,566502010
2018-11-23,70766913,557721784,0,268500,2582970,560304754
2018-11-26,27314799,559093598,0,268500,2566860,561660458
2018-11-27,20292031,553528586,43000,289000,2785960,556314546
2018-11-28,22230196,551789224,0,216000,2116800,553906024
2018-11-29,43558829,556063523,95500,311500,3009090,559072613
2018-11-30,31645661,558867269,0,246000,2442780,561310049
2018-12-03,9583490,559582747,0,246000,2686320,562269067
2018-12-04,136072000,543325538,67000,298000,3292900,546618438
2018-12-05,62562758,550249335,0,231000,2418570,552667905
2018-12-06,44520782,555571910,1500,222500,2213875,557785785
2018-12-07,21955566,553561950,0,191000,1883260,555445210
2018-12-10,13974780,544651798,10000,201000,1943670,546595468
2018-12-11,15544338,538441655,30000,226000,2201240,540642895
2018-12-12,17723531,538260437,0,196000,1912960,540173397
2018-12-13,29754265,535400251,2500,186000,1815360,537215611
2018-12-14,24093365,530093926,82500,268500,2456775,532550701
2018-12-17,15653900,531004030,30000,268500,2483625,533487655
2018-12-18,34291591,536788513,103600,372100,3520066,540308579
2018-12-19,14260059,533861498,0,305600,2832912,536694410
2018-12-20,16606967,538050371,13000,318600,2994840,541045211
2018-12-21,10344062,532354470,1000,306600,2811522,535165992
2018-12-24,9847000,532832650,0,221600,2034288,534866938
2018-12-25,25383939,513200967,88700,309300,2635236,515836203
2018-12-26,9395894,501990256,0,223300,1886885,503877141
2018-12-27,9659948,500497494,0,220100,1813624,502311118
2018-12-28,10969311,496661334,30000,180100,1505636,498166970
2019-01-02,7488532,492493674,55300,205400,1731522,494225196
2019-01-03,14970551,491145373,125800,329700,2861796,494007169
2019-01-04,43070686,502909678,41800,248500,2281230,505190908
2019-01-07,25128659,499004541,27100,227600,2066608,501071149
2019-01-08,20448602,505466916,64500,260100,2333097,507800013
2019-01-09,24479728,510912552,48000,258100,2315157,513227709
2019-01-10,13315712,512705358,5600,170700,1510695,514216053
2019-01-11,11548873,512474536,0,159300,1436886,513911422
2019-01-14,45775532,513200532,199600,353900,3262958,516463490
2019-01-15,23182729,511979169,0,243400,2292828,514271997
2019-01-16,21494735,516608609,1800,177100,1645259,518253868
2019-01-17,28917956,517010289,194500,340600,3198234,520208523
2019-01-18,0,510973124,0,180100,1691139,512664263
2019-01-21,0,507566474,0,170100,1597239,509163713
2019-01-22,0,504678700,0,170100,1597239,506275939
2019-01-23,0,500370906,0,160100,1503339,501874245
2019-01-24,0,498039992,0,160100,1503339,499543331
2019-01-25,1387319,495124453,0,160100,1653833,496778286
2019-01-28,77652322,511533198,75600,230700,2320842,513854040
2019-01-29,31155231,509343527,135300,350400,3489984,512833511
2019-01-30,19629438,511374184,5000,239500,2268065,513642249
2019-01-31,20047580,511774728,101100,299200,2851376,514626104
2019-02-01,21349725,505256207,1500,271600,2672544,507928751
2019-02-11,30523335,510879938,500,270600,2746590,513626528
2019-02-12,46911864,531364437,5000,200100,2051025,533415462
2019-02-13,46379547,542936114,172450,297550,3130226,546066340
2019-02-14,41069830,541825492,70000,200100,2111055,543936547
2019-02-15,64975513,557810430,172500,357600,3951480,561761910
2019-02-18,73777929,549330093,14700,210100,2346817,551676910
2019-02-19,86066522,561865990,111700,301800,3371106,565237096
2019-02-20,51184044,563508095,400,126700,1382297,564890392
2019-02-21,57442027,561246625,168000,284700,3134547,564381172
2019-02-22,96848565,563388645,87900,198400,2402624,565791269
2019-02-25,163818717,585975946,174132,284632,3674599,589650545
2019-02-26,153249951,617945196,15000,125500,1553690,619498886
2019-02-27,136908776,608965797,215500,336000,4458720,613424517
2019-02-28,136904601,627004521,36200,226700,3010576,630015097
2019-03-01,87641099,606604841,47400,174100,2268523,608873364
2019-03-04,137862167,594546064,138100,248600,3229314,597775378
2019-03-05,81782826,592875137,43600,159100,2068300,594943437
2019-03-06,143402858,614673279,201149,311649,4185446,618858725
2019-03-07,161581134,618433617,60500,256000,3781120,622214737
2019-03-08,273777673,645520342,103200,223700,3333130,648853472
2019-03-11,183906224,679513962,148500,277200,4232844,683746806
2019-03-12,149677965,672645766,45000,177600,2679984,675325750
2019-03-13,130541941,685624231,71200,205100,2918573,688542804
2019-03-14,85837253,688620729,18000,150600,2048160,690668889
2019-03-15,64267238,669148571,128000,195600,2712972,671861543
2019-03-18,50316425,648472950,112448,198048,2792477,651265427
2019-03-19,56421514,651705285,0,152600,2153186,653858471
2019-03-20,59051383,652792367,109100,190500,2718435,655510802
2019-03-21,92201029,660964062,71200,147600,2115108,663079170
2019-03-22,151960123,678500088,169100,231700,3466232,681966320
2019-03-25,101570732,668615988,80000,141200,2072816,670688804
2019-03-26,77294580,662571960,1700,141700,1954043,664526003
2019-03-27,43564480,665989559,1200,141200,1923144,667912703
2019-03-28,44954260,672063862,0,141200,1916084,673979946
2019-03-29,77356412,676854037,162150,217750,3122535,679976572
2019-04-01,89868586,671185566,0,70600,1037114,672222680
2019-04-02,103568230,662987783,185500,251100,3728835,666716618
2019-04-03,122312377,656385634,8800,144400,2359496,658745130
2019-04-04,308884964,711957977,95500,166900,2999193,714957170
2019-04-08,258380709,738171240,30000,95600,1586960,739758200
2019-04-09,166519427,755853508,99300,169900,2856019,758709527
2019-04-10,126204685,776150392,0,74400,1203048,777353440
2019-04-11,108855073,772008245,213900,285800,4692836,776701081
2019-04-12,128027442,750797716,35000,140300,2413160,753210876
2019-04-15,127403277,738491245,5000,140300,2288293,740779538
2019-04-16,89122668,737061008,95500,220200,3584856,740645864
2019-04-17,96670917,763813337,2400,127100,2071730,765885067
2019-04-18,178835142,806698241,190500,287600,4958224,811656465
2019-04-19,195691712,778722263,35000,172100,3263016,781985279
2019-04-22,430222133,786622287,135000,274600,5217400,791839687
2019-04-23,229468030,787040263,35000,117100,2031685,789071948
2019-04-24,103725383,801288772,0,112100,1940451,803229223
2019-04-25,104206965,792684695,137500,249600,3993600,796678295
2019-04-26,51458000,781197698,0,154600,2481330,783679028
2019-04-29,85221980,776911912,45000,194600,2856728,779768640
2019-04-30,44508774,750662067,63000,205100,3131877,753793944
2019-05-06,33032614,722459863,87500,191000,2624340,725084203
2019-05-07,50664880,710367603,76600,237600,3409560,713777163
2019-05-08,70049918,730157479,30000,194600,2895648,733053127
2019-05-09,48599228,734511960,43000,185100,2741331,737253291
2019-05-10,72973902,730072595,132500,234600,3549498,733622093
2019-05-13,45887792,710154820,74800,222100,3187135,713341955
2019-05-14,29729763,701577821,22500,214600,2993670,704571491
2019-05-15,28979348,696274923,0,142100,2019241,698294164
2019-05-16,48027260,697578981,65500,152600,2218804,699797785
2019-05-17,43509569,682823739,15000,115100,1531981,684355720
2019-05-20,17575635,674322458,100000,202100,2712182,677034640
2019-05-21,24179731,676329584,22500,164600,2243498,678573082
2019-05-22,14933502,668415563,0,142100,1884246,670299809
2019-05-23,49679606,673594105,179300,286600,3946482,677540587
2019-05-24,40010005,675667849,30000,191100,2702154,678370003
2019-05-27,36543772,679554420,22500,213600,3048072,682602492
2019-05-28,42476068,677231909,103000,286600,4106978,681338887
2019-05-29,34212822,678246693,0,141100,1997976,680244669
2019-05-30,28266925,680060065,0,141100,1921782,681981847
2019-05-31,14963216,671003287,0,141100,1902028,672905315
2019-06-03,16303258,659870517,13000,154100,2012546,661883063
2019-06-04,22585557,610260309,27500,163600,2005736,612266045
2019-06-05,15761560,609327548,2500,143600,1769152,611096700
2019-06-06,18017656,609341610,2500,141100,1728475,611070085
2019-06-10,30516922,612092654,145500,286200,3629016,615721670
2019-06-11,60555791,634082853,400,141100,1863931,635946784
2019-06-12,45899658,642874269,104000,215100,2811357,645685626
2019-06-13,35594174,632457723,102492,214592,2849782,635307505
2019-06-14,38093339,638446254,43000,207600,2748624,641194878
2019-06-17,17301421,638211402,0,142100,1818880,640030282
2019-06-18,12204432,636181597,60000,172100,2220090,638401687
2019-06-19,30296651,636229663,90500,212600,2793564,639023227
2019-06-20,64797509,644918135,105000,215100,2968380,647886515
2019-06-21,69910560,647320771,82500,194600,2782780,650103551
2019-06-24,51940624,660730831,0,142100,1965243,662696074
2019-06-25,60020811,677974340,95500,207600,2933388,680907728
2019-06-26,34439400,675252452,80000,244600,3397494,678649946
2019-06-27,28492292,674368588,0,142100,1982295,676350883
2019-06-28,25038684,662450284,0,142100,1936823,664387107
2019-07-01,41207632,669151578,90000,202100,2815253,671966831
2019-07-02,46677515,672968547,115500,227600,3229644,676198191
2019-07-03,30648838,669229334,0,142100,1979453,671208787
2019-07-04,32143644,670132568,174473,286573,4066471,674199039
2019-07-05,42216995,658302639,0,164600,2337320,660639959
2019-07-08,27919139,654308954,0,142100,1895614,656204568
2019-07-09,16653573,652964158,0,142100,1912666,654876824
2019-07-10,11574838,651697169,0,142100,1875720,653572889
2019-07-11,12990157,647553182,0,142100,1861510,649414692
2019-07-12,13106286,648288784,0,141100,1862520,650151304
2019-07-15,23326141,656269175,0,141100,1892151,658161326
2019-07-16,21835519,660870608,60000,201100,2688707,663559315
2019-07-17,10085526,658510510,0,171100,2297873,660808383
2019-07-18,16341377,656462211,0,131100,1718721,658180932
2019-07-19,17040901,656386546,10000,141100,1866753,658253299
2019-07-22,34070169,658890124,29950,161050,1988968,660879092
2019-07-23,6886806,653274651,0,131100,1654482,654929133
2019-07-24,13385953,652868303,0,101100,1291047,654159350
2019-07-25,7337948,648280225,0,101100,1290036,649570261
2019-07-26,13859069,645569046,169500,270600,3509682,649078728
2019-07-29,17396942,649763806,0,101100,1302168,651065974
2019-07-30,22073679,648900043,127000,223100,2913686,651813729
2019-07-31,12519310,648828516,0,96100,1232963,650061479
2019-08-01,15091595,649567540,37000,129500,1678320,651245860
2019-08-02,23522245,650905051,0,82500,1037025,651942076
2019-08-05,14311092,650407739,0,72500,894650,651302389
2019-08-06,21613953,652116276,0,57500,672175,652788451
2019-08-07,6579011,648487611,0,57500,664125,649151736
2019-08-08,12422708,644029851,225498,282998,3427106,647456957
2019-08-09,14455424,647154684,0,107500,1267425,648422109
2019-08-12,18689737,651863273,199700,292200,3558996,655422269
2019-08-13,9484139,650736280,0,165200,1985704,652721984
2019-08-14,21251655,644350849,0,135200,1594008,645944857
2019-08-15,13054084,639563862,0,127700,1474935,641038797
2019-08-16,15092788,639212676,198800,326500,3806990,643019666
2019-08-19,27449996,638118229,10000,211500,2573955,640692184
2019-08-20,22251631,636335865,37000,236500,2882935,639218800
2019-08-21,18972927,630765089,0,199500,2405970,633171059
2019-08-22,15342489,631009262,166300,365800,4499340,635508602
2019-08-23,18594826,630294637,17100,243100,3002285,633296922
2019-08-26,15365465,631233262,0,243100,2931786,634165048
2019-08-27,23358725,626938985,110000,353100,4413750,631352735
2019-08-28,15378454,626181468,0,243100,2994992,629176460
2019-08-29,23555814,624254320,130600,353100,4424343,628678663
2019-08-30,22219619,620796176,0,184700,2236717,623032893
2019-09-02,10504676,612796581,0,169700,2109371,614905952
2019-09-03,15405527,587576993,0,159700,1972295,589549288
2019-09-04,34348684,592905396,37000,196700,2462684,595368080
2019-09-05,65623083,596870190,222500,347200,4576096,601446286
2019-09-06,41756538,600189272,48400,233100,3111885,603301157
2019-09-09,31701796,599259038,7700,207100,2785495,602044533
2019-09-10,43293425,599787610,236900,392300,5382356,605169966
2019-09-11,54176256,606756355,51300,214200,3005226,609761581
2019-09-12,40648749,587025960,33945,226845,3087360,590113320
2019-09-16,32344055,590156273,30000,222900,3031440,593187713
2019-09-17,64231218,597053873,243900,436800,6163248,603217121
2019-09-18,109729752,620681918,31800,340700,5059395,625741313
2019-09-19,59584829,629071197,48400,243100,3573570,632644767
2019-09-20,55334187,614912147,0,229100,3321950,618234097
2019-09-23,46003270,592662528,52200,214498,2912882,595575410
2019-09-24,32142848,592932959,61000,232298,3110470,596043429
2019-09-25,29798240,592228077,154500,321600,4238688,596466765
2019-09-26,6061646,579618335,0,174600,2070756,581689091
2019-09-27,3033481,562076372,0,168600,1798962,563875334
2019-09-30,29070793,530888119,250200,358800,3552120,534440239
2019-10-08,15366760,527364883,51171,301571,3079040,530443923
2019-10-09,15723644,531624537,0,184600,1868152,533492689
2019-10-10,17875272,529726493,98000,281600,2903296,532629789
2019-10-11,28906807,528296675,116100,301700,3182935,531479610
2019-10-14,40519738,528495849,139400,345800,3810716,532306565
2019-10-15,18826838,521882972,112800,326600,3491354,525374326
2019-10-16,15774102,521576025,142700,392500,4203675,525779700
2019-10-17,21869936,531919265,1100,300800,3212544,535131809
2019-10-18,14610055,531831675,30400,218500,2313915,534145590
2019-10-21,10759214,528430267,75400,246500,2642480,531072747
2019-10-22,12641305,530419816,0,239400,2532852,532952668
2019-10-23,8578577,525915344,16200,244400,2514876,528430220
2019-10-24,6714307,520447119,0,228900,2357670,522804789
2019-10-25,8150783,522043029,0,227900,2370160,524413189
2019-10-28,36887944,534095130,124300,319700,3455957,537551087
2019-10-29,17077907,538168780,0,204900,2118666,540287446
2019-10-30,5438402,536082953,0,204900,2069490,538152443
2019-10-31,8522903,534627538,38500,243400,2472944,537100482
2019-11-01,13037824,537472821,0,204900,2108421,539581242
2019-11-04,14267473,537828904,0,204900,2063343,539892247
2019-11-05,8886953,537163758,52500,251400,2574336,539738094
2019-11-06,12845198,513242552,0,198900,1945242,515187794
2019-11-07,7664746,502200698,0,178900,1746064,503946762
2019-11-08,41407537,514447573,298900,472800,4869840,519317413
2019-11-11,23061333,506369314,20000,290233,2873306,509242620
2019-11-12,15619455,503373170,0,268933,2587135,505960305
2019-11-13,6314895,503231398,20000,288933,2762199,505993597
2019-11-14,7963903,502051872,0,268933,2587135,504639007
2019-11-15,11786608,499046241,0,268933,2482251,501528492
2019-11-18,12714031,497815185,129100,353033,3364404,501179589
2019-11-19,14939994,491414114,78700,268337,2627019,494041133
2019-11-20,6489154,485579198,0,199600,1926140,487505338
2019-11-21,10468498,486555593,197800,397400,3906442,490462035
2019-11-22,15771865,484091960,0,221600,2125144,486217104
2019-11-25,10581877,486593136,16500,228100,2166950,488760086
2019-11-26,6290710,483460562,25400,246500,2346680,485807242
2019-11-27,7651331,481135820,111000,325700,3129977,484265797
2019-11-28,8510218,483921306,0,261200,2489236,486410542
2019-11-29,26238751,492286055,176886,361486,3567867,495853922
2019-12-02,12776421,488531816,53000,265386,2645898,491177714
2019-12-03,9471582,487026046,89300,337900,3439822,490465868
2019-12-04,7914863,487182996,8000,288400,2930144,490113140
2019-12-05,31793602,500972794,102900,343500,3620490,504593284
2019-12-06,11628095,501140775,12500,243100,2540395,503681170
2019-12-09,14803943,504777828,30600,210600,2198664,506976492
2019-12-10,9681033,500425399,0,175100,1829795,502255194
2019-12-11,15268630,507548092,23400,198500,2074325,509622417
2019-12-12,7474130,505525250,7300,176700,1834146,507359396
2019-12-13,25980049,505182154,187200,301425,3210176,508392330
2019-12-16,33399187,514559113,0,151225,1657426,516216539
2019-12-17,30586786,512138579,147500,291700,3240787,515379366
2019-12-18,19220804,507566938,38600,154600,1691324,509258262
2019-12-19,19943943,512527109,33200,177800,1952244,514479353
2019-12-20,14808482,507377639,0,177800,1911350,509288989
2019-12-23,9587870,505208274,0,157800,1625340,506833614
2019-12-24,12007787,505980935,60000,217800,2271654,508252589
2019-12-25,8475164,507093900,0,157800,1642698,508736598
2019-12-26,14071713,511000127,42500,200300,2107156,513107283
2019-12-27,20023822,512702192,0,157800,1630074,514332266
2019-12-30,11907029,509662017,54900,172700,1797807,511459824
2019-12-31,19075289,512933750,40300,171300,1815780,514749530
2020-01-02,22483781,519368803,22500,153500,1640915,521009718
2020-01-03,20351856,506438232,0,131000,1401700,507839932
2020-01-06,23350841,500812204,0,116000,1243520,502055724
2020-01-07,22580180,503532470,37000,153000,1666170,505198640
2020-01-08,16682833,502553329,0,116000,1221480,503774809
2020-01-09,13097729,499554145,0,116000,1240040,500794185
2020-01-10,42180150,514864496,164800,239000,2585980,517450476
2020-01-13,24130646,514164675,0,148200,1590186,515754861
2020-01-14,28176391,512625176,163500,252700,2746849,515372025
2020-01-15,19025745,516512641,0,140200,1498738,518011379
2020-01-16,16035931,515413914,25800,134000,1429780,516843694
2020-01-17,11544067,514883309,0,84200,895888,515779197
2020-01-20,15983945,517970710,29500,103700,1102331,519073041
2020-01-21,11542946,513697248,0,81200,838796,514536044
2020-01-22,16735320,512277904,0,74200,757582,513035486
2020-01-23,18219849,499332355,5500,79700,760338,500092693
2020-02-03,500797,491095692,0,56500,485335,491581027
2020-02-04,18018825,478263324,0,55500,446775,478710099
2020-02-05,12342361,475540625,1000,56500,471210,476011835
2020-02-06,9109152,464950531,0,56500,481945,465432476
2020-02-07,8569114,457354406,0,55500,476745,457831151
2020-02-10,5219441,451996372,4500,54500,478510,452474882
2020-02-11,14336116,459932188,1000,55500,485625,460417813
2020-02-12,9139338,457645498,15000,70500,624630,458270128
2020-02-13,6434508,456580394,0,60500,526350,457106744
2020-02-14,11439206,453938564,35000,69500,608125,454546689
2020-02-17,11471396,448789108,30500,65000,592800,449381908
2020-02-18,9883110,445615117,10000,45500,423605,446038722
2020-02-19,18782822,449814055,169500,214000,2007320,451821375
2020-02-20,26175463,455140901,30500,70500,687375,455828276
2020-02-21,44292198,458906801,85600,136100,1366444,460273245
2020-02-24,29512733,453160504,0,63100,644251,453804755
2020-02-25,23317691,449376276,0,37700,380770,449757046
2020-02-26,13272046,447651284,0,37700,371722,448023006
2020-02-27,8200751,443478441,0,37700,372476,443850917
2020-02-28,7768855,432452970,1990,39690,356019,432808989
2020-03-02,9489267,431064888,76921,116611,1114801,432179689
2020-03-03,12484330,428967518,0,44690,425002,429392520
2020-03-04,8701341,431296514,0,38090,364902,431661416
2020-03-05,33237186,443361441,133900,171990,1733659,445095100
2020-03-06,14818956,438076727,0,50000,493000,438569727
2020-03-09,10772205,436113939,0,10000,93700,436207639
2020-03-10,11070263,435625098,0,10000,95900,435720998
2020-03-11,10833352,433273076,10000,20000,189800,433462876
2020-03-12,11763112,433211604,0,20000,184200,433395804
2020-03-13,10616794,430409999,0,16700,150300,430560299
2020-03-16,10713467,430159511,0,13400,114302,430273813
2020-03-17,13521845,434861983,144500,157900,1373730,436235713
2020-03-18,12677098,432170219,0,17000,140420,432310639
2020-03-19,11209692,435233344,20000,30000,249300,435482644
2020-03-20,6860780,435797523,90900,120900,1016769,436814292
2020-03-23,4164665,429217968,0,35000,284550,429502518
2020-03-24,10318239,434281437,30000,65000,542100,434823537
2020-03-25,15106773,439078683,60000,80000,690400,439769083
2020-03-26,5570977,434051688,0,10000,84900,434136588
2020-03-27,6554899,430689308,102000,112000,952000,431641308
2020-03-30,5485461,424063455,0,10000,83700,424147155
2020-03-31,6079628,425279000,0,10000,82400,425361400
2020-04-01,4511531,422931587,0,10000,81500,423013087
2020-04-02,6112430,423246383,0,10000,83200,423329583
2020-04-03,5981558,421148737,0,10000,82000,421230737
2020-04-07,7560721,416497638,82100,92100,785613,417283251
2020-04-08,7751601,414295653,0,10000,86100,414381753
2020-04-09,13591644,415392340,37000,47000,407960,415800300
2020-04-10,8045025,415840313,0,10000,84200,415924513
2020-04-13,9188885,404678961,0,10000,81400,404760361
2020-04-14,7726391,405537339,0,10000,83000,405620339
2020-04-15,6833410,404621813,0,10000,81500,404703313
2020-04-16,5944875,404358095,0,10000,81900,404439995
2020-04-17,9210177,404448856,0,10000,81700,404530556
2020-04-20,13747654,406218049,0,10000,83200,406301249
2020-04-21,7676641,405525106,0,10000,81700,405606806
2020-04-22,4851227,400422240,30000,40000,329200,400751440
2020-04-23,4332490,399130114,0,10000,81500,399211614
2020-04-24,3910688,394663696,0,10000,79100,394742796
2020-04-27,5666175,395205512,60000,70000,563500,395769012
2020-04-28,7203078,393693588,3000,13000,101660,393795248
2020-04-29,6390891,388021985,0,13000,97890,388119875
2020-04-30,6705479,383735221,1300,14300,114543,383849764
2020-05-06,4350688,381382550,0,13000,106080,381488630
2020-05-07,5231918,381067153,0,13000,105170,381172323
2020-05-08,8693999,383450177,0,13000,106990,383557167
2020-05-11,5288791,383356733,0,13000,105820,383462553
2020-05-12,3836251,379692833,0,13000,104520,379797353
2020-05-13,3751460,380918635,0,13000,104520,381023155
2020-05-14,3120896,379867683,3000,16000,126400,379994083
2020-05-15,24887105,393491899,126900,142900,1177496,394669395
2020-05-18,9571645,389815567,0,16000,128800,389944367
2020-05-19,6239620,390927324,0,16000,129600,391056924
2020-05-20,3995631,389305364,0,16000,128160,389433524
2020-05-21,4227277,387013970,0,16000,126560,387140530
2020-05-22,3995191,381652058,0,10000,78300,381730358
2020-05-25,4132408,383559432,0,10000,77900,383637332
2020-05-26,3434176,379921652,0,10000,79400,380001052
2020-05-27,6661253,380908712,0,10000,78200,380986912
2020-05-28,5469851,379921583,30000,40000,314400,380235983
2020-05-29,4817680,368501280,0,10000,77600,368578880
2020-06-01,20625887,376139631,155300,165300,1411662,377551293
2020-06-02,24050608,379204436,10300,35600,296548,379500984
2020-06-03,15487549,377992953,0,25900,216524,378209477
2020-06-04,13841456,382511550,0,10900,91560,382603110
2020-06-05,19107302,381661900,144500,155400,1344210,383006110
2020-06-08,11790712,383889869,0,32400,272484,384162353
2020-06-09,20909614,387502259,89600,122000,1055300,388557559
2020-06-10,12568980,387754131,0,32400,279936,388034067
2020-06-11,16099002,390037974,70000,102400,878592,390916566
2020-06-12,9570510,388240993,0,32400,277344,388518337
2020-06-15,14777108,389575381,500,32900,285572,389860953
2020-06-16,15066288,393344161,0,32400,283176,393627337
2020-06-17,17428011,390456074,0,32400,289980,390746054
2020-06-18,17254955,387652492,0,32400,292248,387944740
2020-06-19,35386900,396676545,69945,102345,929293,397605838
2020-06-22,32674835,403350210,35100,107500,991150,404341360
2020-06-23,22576672,400532243,50000,157500,1417500,401949743
2020-06-24,13373139,397457904,0,72400,635672,398093576
2020-06-29,9047005,387901763,0,72400,616124,388517887
2020-06-30,13312371,389961524,30000,102400,884736,390846260
2020-07-01,16364894,388198752,0,72400,632776,388831528
2020-07-02,36690851,387264179,78000,110400,1014576,388278755
2020-07-03,59600824,393607982,123904,166304,1601508,395209490
2020-07-06,76946870,412326224,69000,104900,1103548,413429772
2020-07-07,78977796,422751791,2000,17900,180611,422932402
2020-07-08,86588708,431732843,95395,111295,1191969,432924812
2020-07-09,70660188,431780487,6900,22800,243504,432023991
2020-07-10,65016663,420878681,150100,166000,1816040,422694721
2020-07-13,85501257,444879302,0,126900,1403514,446282816
2020-07-14,99294439,455509241,87000,172900,1974518,457483759
2020-07-15,178652923,505276969,30900,143800,1695402,506972371
2020-07-16,42828478,468121810,68000,171800,1822798,469944608
2020-07-17,46517204,466756702,20052,163152,1631520,468388222
2020-07-20,23996394,451832281,27906,170858,1759838,453592119
2020-07-21,19162434,443624826,0,142952,1450963,445075789
2020-07-22,31432842,434625494,24000,166952,1732962,436358456
2020-07-23,14682525,425249476,0,145900,1480885,426730361
2020-07-24,19620003,411649821,2400,127400,1197560,412847381
2020-07-27,8803994,408729134,19400,96800,908952,409638086
2020-07-28,12283652,412662628,8000,84800,809840,413472468
2020-07-29,12163149,412458987,0,57400,563094,413022081
2020-07-30,10990641,409419679,0,57400,552188,409971867
2020-07-31,17989755,410621590,0,52400,513520,411135110
2020-08-03,25860674,414239979,0,52400,532384,414772363
2020-08-04,74181218,442091820,180190,192590,2079972,444171792
2020-08-05,93861542,461082200,43700,140700,1618050,462700250
2020-08-06,82436946,496736302,0,140700,1620864,498357166
2020-08-07,42505235,498708105,0,140700,1570212,500278317
2020-08-10,32790784,481976775,22000,162700,1737636,483714411
2020-08-11,20986141,481787803,2400,93100,964516,482752319
2020-08-12,23597858,484326600,50000,143100,1502550,485829150
2020-08-13,15070641,485860991,2700,95800,983866,486844857
2020-08-14,20731098,491670432,10400,62800,646840,492317272
2020-08-17,32495373,490902464,60000,82400,885800,491788264
2020-08-18,25470320,492827733,0,62400,664560,493492293
2020-08-19,16607327,490587200,0,62400,642720,491229920
2020-08-20,11095349,490369348,0,52400,525572,490894920
2020-08-21,8591696,489488323,0,52400,531860,490020183
2020-08-24,6714344,486839017,0,52400,528192,487367209
2020-08-25,11134210,487930036,0,50600,507012,488437048
2020-08-26,13480116,474376368,0,50000,476000,474852368
2020-08-27,8059171,470883329,0,50000,484000,471367329
2020-08-28,10336188,468687332,0,50000,495500,469182832
2020-08-31,23058277,461899918,0,50000,489500,462389418
2020-09-01,10473079,441828845,0,50000,485500,442314345
2020-09-02,13223236,427960167,0,50000,481500,428441667
2020-09-03,17651333,427697355,0,50000,475500,428172855
2020-09-04,7739052,422238101,0,50000,479000,422717101
2020-09-07,9997601,423327320,1100,51100,477785,423805105
2020-09-08,8023709,420425721,0,51100,494137,420919858
2020-09-09,7980089,419516976,0,51100,479318,419996294
2020-09-10,8528614,418033790,0,51100,458878,418492668
2020-09-11,6798695,418032373,30000,81100,738010,418770383
2020-09-14,5999675,416649859,0,61100,556010,417205869
2020-09-15,7513118,419214866,0,61100,549900,419764766
2020-09-16,4871577,417619877,2000,53100,469935,418089812
2020-09-17,3531256,413422370,3000,54100,475539,413897909
2020-09-18,18683878,415324920,0,11100,101565,415426485
2020-09-21,7662752,413393847,0,11100,101121,413494968
2020-09-22,10869778,417451656,0,11100,100899,417552555
2020-09-23,5531099,418087624,7500,18600,169632,418257256
2020-09-24,6359915,408260342,0,11100,97014,408357356
2020-09-25,6127404,406029990,0,11100,97902,406127892
2020-09-28,4781099,404679473,0,11100,95682,404775155
2020-09-29,4788977,405015607,0,11100,95793,405111400
2020-09-30,5492678,402948110,1200,12300,103935,403052045
2020-10-09,2939665,397710210,0,12300,107994,397818204
2020-10-12,10150419,394116993,0,12300,112914,394229907
2020-10-13,8584306,393128278,0,12300,111561,393239839
2020-10-14,7287609,395362225,0,12300,109593,395471818
2020-10-15,6989127,398232773,0,12300,108732,398341505
2020-10-16,2582731,396896948,0,12300,108978,397005926
2020-10-19,5801218,395926705,0,11100,97458,396024163
2020-10-20,4683836,396814913,1900,13000,115960,396930873
2020-10-21,4830897,396998165,10000,23000,202170,397200335
2020-10-22,6465449,397710547,0,13000,114920,397825467
2020-10-23,3126075,395544417,0,13000,113100,395657517
2020-10-26,3264641,393594782,0,13000,110500,393705282
2020-10-27,2309000,390529660,0,13000,110500,390640160
2020-10-28,4768767,390545563,0,13000,110500,390656063
2020-10-29,2984973,389185696,0,13000,109980,389295676
2020-10-30,3325850,387205022,0,13000,106470,387311492
2020-11-02,3995215,386792302,0,13000,107380,386899682
2020-11-03,5222892,377495580,1600,12700,115443,377611023
2020-11-04,16579787,385701536,24400,35500,320210,386021746
2020-11-05,10606538,385248021,0,11500,104305,385352326
2020-11-06,13503239,378916380,32200,43700,406410,379322790
2020-11-09,17741123,382641641,0,11500,108675,382750316
2020-11-10,9245973,377128530,0,11500,107640,377236170
2020-11-11,10779785,377023688,150500,162000,1540620,378564308
2020-11-12,7739450,376663800,25200,126700,1182111,377845911
2020-11-13,5488166,370567668,0,51500,476890,371044558
2020-11-16,9258659,372836152,0,11500,106375,372942527
2020-11-17,3853033,371184460,0,11500,106720,371291180
2020-11-18,6040540,371688416,0,11500,107295,371795711
2020-11-19,19775217,373970583,191494,202594,1953006,375923589
2020-11-20,12896050,370355955,0,31600,306520,370662475
2020-11-23,13432364,370382250,0,11600,114144,370496394
2020-11-24,12163115,373606216,0,11100,105894,373712110
2020-11-25,9240462,373825698,0,11100,104229,373929927
2020-11-26,4552472,375146370,0,11100,104007,375250377
2020-11-27,11390488,377041061,0,11100,106671,377147732
2020-11-30,13090707,374101685,0,11100,106116,374207801
2020-12-01,12060012,375009529,10000,21100,206147,375215676
2020-12-02,30824892,389455281,5000,26100,260217,389715498
2020-12-03,23012958,390844137,0,21100,211000,391055137
2020-12-04,30371034,397079761,123600,144700,1470152,398549913
2020-12-07,16374335,396661692,2400,23500,229360,396891052
2020-12-08,7414234,394729053,0,23500,229360,394958413
2020-12-09,10700360,389025871,0,23500,219490,389245361
2020-12-10,4298397,387631948,0,21100,198340,387830288
2020-12-11,9725477,386259113,100000,121100,1146817,387405930
2020-12-14,5008716,385210575,0,21100,197074,385407649
2020-12-15,4425622,385723618,0,21100,197707,385921325
2020-12-16,7834909,385576181,0,21100,195597,385771778
2020-12-17,11602551,378696984,101400,122500,1081675,379778659
2020-12-18,9348420,382703879,0,21200,182956,382886835
2020-12-21,5212882,383232315,0,21200,184440,383416755
2020-12-22,8638524,376653892,0,21100,174919,376828811
2020-12-23,5627465,376208304,0,11100,93351,376301655
2020-12-24,2691603,372254541,0,11100,92130,372346671
2020-12-25,5829095,373826776,0,11100,93129,373919905
2020-12-28,4455843,373648982,0,11100,92463,373741445
2020-12-29,5306993,373491432,0,11100,93351,373584783
2020-12-30,5475752,372686012,0,11100,93462,372779474
2020-12-31,12624819,375785831,0,11100,96570,375882401
2021-01-04,10723446,374925089,0,11100,97014,375022103
2021-01-05,7556100,368144528,0,11100,96015,368240543
2021-01-06,5644576,366286945,0,11100,93129,366380074
2021-01-07,11528771,359519703,0,11100,87801,359607504
2021-01-08,4596914,358145635,11900,23000,181240,358326875
2021-01-11,4882730,354070812,0,11200,83888,354154700
2021-01-12,9264967,356539479,0,11100,84804,356624283
2021-01-13,6611343,353565508,51500,62600,465118,354030626
2021-01-14,0,352335380,0,42600,316518,352651898
2021-01-15,0,350194175,0,42600,316518,350510693
2021-01-18,0,349424613,0,42600,316518,349741131
2021-01-19,0,348632913,0,42600,316518,348949431
2021-01-20,0,347863468,0,42600,316518,348179986
2021-01-21,0,347008682,0,42600,316518,347325200
2021-01-22,0,345654652,0,42600,316518,345971170
2021-01-25,0,344465766,0,42600,316518,344782284
2021-01-26,0,343635971,0,42600,316518,343952489
2021-01-27,0,343088624,0,42600,316518,343405142
2021-01-28,0,342807788,0,42600,348042,343155830
2021-01-29,0,340868152,0,42600,382974,341251126
2021-02-01,29322199,343339220,161300,203900,2016571,345355791
2021-02-02,31398734,345655361,0,156400,1487364,347142725
2021-02-03,25848159,350696085,6200,162400,1429120,352125205
2021-02-04,32241969,350921621,41499,161199,1560406,352482027
2021-02-05,51812426,351022918,40000,160500,1537590,352560508
2021-02-08,14178476,339484398,43400,163500,1443705,340928103
2021-02-09,18680957,339438943,0,160100,1408880,340847823
2021-02-10,17460912,334061500,0,122700,1144791,335206291
2021-02-18,26202853,342511601,20000,142700,1361358,343872959
2021-02-19,18701257,344140143,0,122700,1193871,345334014
2021-02-22,19618753,338810867,0,122700,1191417,340002284
2021-02-23,16057151,341070889,0,122700,1168104,342238993
2021-02-24,29794409,346994747,81200,163900,1634083,348628830
2021-02-25,17050049,348863506,0,112700,1137143,350000649
2021-02-26,10466396,348698209,9800,122500,1193150,349891359
2021-03-01,10870579,348069771,0,122500,1158850,349228621
2021-03-02,36122949,348998699,22700,145200,1511532,350510231
2021-03-03,26592847,355919360,0,145200,1498464,357417824
2021-03-04,15658026,348856913,0,145200,1444740,350301653
2021-03-05,17365197,353397327,40000,114000,1144560,354541887
2021-03-08,15018585,354886969,0,114000,1104660,355991629
2021-03-09,12187291,349988141,0,74000,690420,350678561
2021-03-10,6060018,351195854,0,72700,680472,351876326
2021-03-11,9133375,353233148,0,72700,696466,353929614
2021-03-12,14789003,351570344,50000,122700,1222092,352792436
2021-03-15,9033620,348749084,0,102700,990028,349739112
2021-03-16,7587991,350332836,0,102700,990028,351322864
2021-03-17,17928900,348449203,101200,163900,1737340,350186543
2021-03-18,26082148,352395747,40000,201700,2138020,354533767
2021-03-19,16300541,353190708,0,171100,1796550,354987258
2021-03-22,21668794,360985086,0,171100,1791417,362776503
2021-03-23,28100454,359003055,32100,203200,2174240,361177295
2021-03-24,15906794,364194207,1800,145000,1496400,365690607
2021-03-25,19156624,365873784,4300,149300,1539283,367413067
2021-03-26,28157999,358000211,40200,184500,1998135,359998346
2021-03-29,25117631,361082516,0,184500,1894815,362977331
2021-03-30,9773074,362235682,0,182100,1870167,364105849
2021-03-31,13973571,361943129,900,183000,1822680,363765809
2021-04-01,10857358,361443493,0,152100,1522521,362966014
2021-04-02,11378845,361471181,0,152100,1521000,362992181
2021-04-06,7635572,357930361,20000,172100,1731326,359661687
2021-04-07,11873072,362291456,0,152100,1546857,363838313
2021-04-08,15733263,363865588,20000,172100,1755420,365621008
2021-04-09,10773647,361881885,0,172100,1779514,363661399
2021-04-12,9081617,354016792,3200,155300,1518834,355535626
2021-04-13,6285874,354324135,0,152100,1504269,355828404
2021-04-14,4372591,354633412,0,72100,717395,355350807
2021-04-15,19190355,352956708,112000,184100,1934891,354891599
2021-04-16,14158300,347249179,0,141100,1497071,348746250
2021-04-19,17207267,352462209,0,141100,1495660,353957869
2021-04-20,17935072,353075157,0,141100,1497071,354572228
2021-04-21,37505902,361229970,28300,149400,1664316,362894286
2021-04-22,16052215,354787018,16400,165800,1807220,356594238
2021-04-23,14934979,349382062,0,123500,1353560,350735622
2021-04-26,13218262,348854117,8000,131500,1391270,350245387
2021-04-27,10014932,348956450,0,129100,1355550,350312000
2021-04-28,15059658,354085988,31200,160300,1694371,355780359
2021-04-29,10915429,358167525,4800,125900,1289216,359456741
2021-04-30,13003296,354843028,0,121100,1234009,356077037
2021-05-06,10087549,357844980,0,41100,423330,358268310
2021-05-07,19793518,350891086,0,41100,405246,351296332
2021-05-10,7607054,345577187,0,41100,390039,345967226
2021-05-11,9547950,347400789,0,41100,398670,347799459
2021-05-12,5551284,344767544,0,41100,401958,345169502
2021-05-13,6937770,346026356,0,41100,396615,346422971
2021-05-14,12599389,344594131,0,41100,411000,345005131
2021-05-17,7212952,343405529,0,41100,399492,343805021
2021-05-18,5245584,344773680,0,41100,401136,345174816
2021-05-19,7012835,344211444,0,41100,403602,344615046
2021-05-20,8980887,346626742,0,41100,405246,347031988
2021-05-21,4697543,344395181,0,41100,398670,344793851
2021-05-24,4014998,343711666,0,41100,399081,344110747
2021-05-25,14887608,348404009,40000,81100,804512,349208521
2021-05-26,19418250,348048055,105023,186123,1885426,349933481
2021-05-27,13218939,349668037,0,141100,1419466,351087503
2021-05-28,19369788,355831902,20000,161100,1657719,357489621
2021-05-31,13508335,355801155,0,121100,1250963,357052118
2021-06-01,9994592,356410776,0,61100,621387,357032163
2021-06-02,9643179,355787592,0,41100,407712,356195304
2021-06-03,8141293,351177134,0,41100,401547,351578681
2021-06-04,9547130,346689982,0,41100,399081,347089063
2021-06-07,4263457,344950626,0,41100,399081,345349707
2021-06-08,5732848,345300715,0,41100,403602,345704317
2021-06-09,11893352,349364199,0,41100,407712,349771911
2021-06-10,7561670,349476437,0,41100,401547,349877984
2021-06-11,6278458,349215025,0,11100,106782,349321807
2021-06-15,4042353,345162250,0,11100,104784,345267034
2021-06-16,5045033,343856264,0,11100,104118,343960382
2021-06-17,6716836,346338565,0,11100,106338,346444903
2021-06-18,5625170,345729699,16000,27100,260431,345990130
2021-06-21,6422759,347659043,0,11100,105783,347764826
2021-06-22,6803486,350440711,0,11100,107892,350548603
2021-06-23,4591327,346857712,0,11100,106560,346964272
2021-06-24,4271705,334064387,0,11100,104118,334168505
2021-06-25,6195795,333732429,0,11100,105672,333838101
2021-06-28,11165838,337175956,0,11100,107115,337283071
2021-06-29,3763075,333512380,0,11100,105450,333617830
2021-06-30,5177247,335062724,0,11100,105117,335167841
2021-07-01,3341953,332264073,0,11100,102120,332366193
2021-07-02,3976663,325550304,0,11100,100122,325650426
2021-07-05,6182414,321582183,0,11100,101121,321683304
2021-07-06,1962647,320154994,0,11100,101232,320256226
2021-07-07,2301229,320508476,0,11100,101121,320609597
2021-07-08,2347734,320526840,0,11100,100344,320627184
2021-07-09,3451568,315815635,0,11100,100677,315916312
2021-07-12,6018365,314356059,0,11100,101565,314457624
2021-07-13,3887135,314599086,0,11100,101454,314700540
2021-07-14,7349540,316337245,0,11100,101010,316438255
2021-07-15,3120143,314678013,0,11100,99678,314777691
2021-07-16,3261443,314428739,0,11100,98901,314527640
2021-07-19,5086573,311523641,0,11100,102009,311625650
2021-07-20,3223545,310408126,0,11100,102120,310510246
2021-07-21,3151489,308269429,0,11100,102120,308371549
2021-07-22,4008015,309664247,0,11100,101898,309766145
2021-07-23,11758815,312239782,0,11100,102453,312342235
2021-07-26,7908023,310921207,0,11100,98457,311019664
2021-07-27,3113130,308255964,0,11100,94905,308350869
2021-07-28,4316242,309404611,0,11100,92796,309497407
2021-07-29,3998974,309141708,0,11100,93795,309235503
2021-07-30,1175642,305251583,0,11100,94461,305346044
2021-08-02,4464457,305631430,0,11100,96237,305727667
2021-08-03,4057869,303031836,0,11100,96126,303127962
2021-08-04,2225993,302589031,0,11100,95793,302684824
2021-08-05,4268172,304073406,0,11100,94683,304168089
2021-08-06,2997421,304567277,0,11100,94905,304662182
2021-08-09,4715059,304872485,0,11100,96348,304968833
2021-08-10,4143461,305405137,0,11100,97902,305503039
2021-08-11,3940689,305720597,0,11100,96459,305817056
2021-08-12,4534780,305720654,0,11100,96792,305817446
2021-08-13,4256214,305187647,0,11100,95571,305283218
2021-08-16,6728882,306037716,22000,33100,290618,306328334
2021-08-17,8566951,308702504,60000,71100,615726,309318230
2021-08-18,12696967,312077071,40000,51100,457345,312534416
2021-08-19,8322369,312877530,0,31100,273680,313151210
2021-08-20,7894693,309509275,0,11100,96348,309605623
2021-08-23,4284500,308593364,0,11100,96237,308689601
2021-08-24,3602631,307928737,0,11100,95904,308024641
2021-08-25,3901604,306985303,0,11100,95682,307080985
2021-08-26,2691506,305063052,0,11100,95238,305158290
2021-08-27,2912473,303800834,0,11100,93906,303894740
2021-08-30,2735562,302513184,60000,71100,603639,303116823
2021-08-31,5635415,304997221,0,11100,94350,305091571
2021-09-01,13092833,310407743,90019,101119,885802,311293545
2021-09-02,5420387,307958386,0,11119,96846,308055232
2021-09-03,34238970,306088015,60000,71119,663540,306751555
2021-09-06,21513209,307638653,0,10019,93577,307732230
2021-09-07,12638124,305618104,0,10019,93077,305711181
2021-09-08,10706914,302247369,0,10019,92876,302340245
2021-09-09,21695596,309284878,0,10019,94479,309379357
2021-09-10,19666714,308788182,0,10000,93300,308881482
2021-09-13,7883967,308772525,0,10000,92600,308865125
2021-09-14,7421405,306043031,0,10000,90200,306133231
2021-09-15,4889555,305177577,0,10000,90600,305268177
2021-09-16,6536013,306079361,0,10000,88700,306168061
2021-09-17,5449120,302462572,0,10000,91300,302553872
2021-09-22,6148162,305702700,0,10000,90100,305792800
2021-09-23,8284851,302590114,0,10000,92000,302682114
2021-09-24,6724887,302776270,0,10000,92200,302868470
2021-09-27,5584045,301238316,0,10000,87100,301325416
2021-09-28,2731088,301313711,0,10000,86900,301400611
2021-09-29,3242683,300105096,0,10000,84700,300189796
2021-09-30,1971167,297551252,0,10000,86600,297637852
2021-10-08,5855106,295425368,100000,110000,996600,296421968
2021-10-11,5033987,297001769,0,50000,444500,297446269
2021-10-12,9054523,296420906,0,50000,428000,296848906
2021-10-13,4149244,295566551,0,10000,85800,295652351
2021-10-14,2308530,294101842,0,10000,86200,294188042
2021-10-15,3195294,295555576,0,10000,85400,295640976
2021-10-18,2309779,296401270,0,10000,85600,296486870
2021-10-19,5424391,297455247,60000,70000,605500,298060747
2021-10-20,5233366,298676558,0,10000,86200,298762758
2021-10-21,2272920,297963368,0,10000,86000,298049368
2021-10-22,646165,296472886,0,10000,86500,296559386
2021-10-25,5504673,298323465,0,10000,84600,298408065
2021-10-26,1288320,296946772,0,10000,84900,297031672
2021-10-27,4334634,297233795,0,10000,81300,297315095
2021-10-28,1646559,296885777,0,10000,80800,296966577
2021-10-29,2318863,295336260,0,10000,82400,295418660
2021-11-01,731564,293241800,0,10000,82400,293324200
2021-11-02,2919968,293071868,0,10000,80500,293152368
2021-11-03,1254781,293384534,0,10000,81200,293465734
2021-11-04,890092,292335584,0,10000,81600,292417184
2021-11-05,2383246,292496502,0,10000,82800,292579302
2021-11-08,1232071,292021109,0,10000,82800,292103909
2021-11-09,3285340,292030378,0,10000,83900,292114278
2021-11-10,2382399,292256364,0,10000,84600,292340964
2021-11-11,3571135,290099826,0,10000,85200,290185026
2021-11-12,1546591,289067660,0,10000,85600,289153260
2021-11-15,1656270,283605895,0,0,0,283605895
2021-11-16,14628760,276277926,0,0,0,276277926
2021-11-17,5274072,274414502,0,0,0,274414502
2021-11-18,8723381,274014599,0,0,0,274014599
2021-11-19,8112404,276035993,0,0,0,276035993
2021-11-22,9357791,280794148,0,0,0,280794148
2021-11-23,4679189,275830695,0,0,0,275830695
2021-11-24,4342997,267432763,0,0,0,267432763
2021-11-25,2946138,266404812,0,0,0,266404812
2021-11-26,3100386,265176677,0,0,0,265176677
2021-11-29,3705880,266188873,0,0,0,266188873
2021-11-30,3488346,265361749,0,0,0,265361749
2021-12-01,9264293,267652454,0,0,0,267652454
2021-12-02,4919940,268512332,0,0,0,268512332
2021-12-03,4102952,269415398,0,0,0,269415398
2021-12-06,6524242,267974954,0,0,0,267974954
2021-12-07,7044411,266768220,0,0,0,266768220
2021-12-08,3764660,267586832,0,0,0,267586832
2021-12-09,9390428,272541457,0,0,0,272541457
2021-12-10,4783628,272383167,0,0,0,272383167
2021-12-13,5475282,274448339,0,0,0,274448339
2021-12-14,3527997,274091179,0,0,0,274091179
2021-12-15,10189733,274949623,100000,100000,798000,275747623
2021-12-16,6498443,276216300,0,0,0,276216300
2021-12-17,3072477,273542475,0,0,0,273542475
2021-12-20,2223116,271446933,0,0,0,271446933
2021-12-21,5928386,273014175,0,0,0,273014175
2021-12-22,8003980,273567487,100000,100000,807000,274374487
2021-12-23,7232533,275763017,0,40000,315600,276078617
2021-12-24,16649397,279518801,0,0,0,279518801
2021-12-27,13482930,280783441,0,0,0,280783441
2021-12-28,11751059,278893467,0,0,0,278893467
2021-12-29,3488367,269684103,0,0,0,269684103
2021-12-30,3863347,266944181,0,0,0,266944181
2021-12-31,6399353,263144334,0,0,0,263144334
2022-01-04,4489729,255762288,0,0,0,255762288
2022-01-05,7735421,259101030,0,0,0,259101030
2022-01-06,8491170,262989594,0,0,0,262989594
2022-01-07,9668175,260296042,0,0,0,260296042
2022-01-10,6899253,259286980,0,0,0,259286980
2022-01-11,4257141,255459876,0,0,0,255459876
2022-01-12,5486929,254303776,0,0,0,254303776
2022-01-13,2838191,253291488,0,0,0,253291488
2022-01-14,6387719,256395193,90000,90000,719100,257114293
2022-01-17,4950655,255839938,200,200,1600,255841538
2022-01-18,7297796,257464932,0,0,0,257464932
2022-01-19,3216086,256826988,0,0,0,256826988
2022-01-20,4405765,256103238,0,0,0,256103238
2022-01-21,1382648,255635795,0,0,0,255635795
2022-01-24,3165059,255870085,0,0,0,255870085
2022-01-25,4196047,254680919,0,0,0,254680919
2022-01-26,1749015,253972082,0,0,0,253972082
2022-01-27,1064204,250608415,0,0,0,250608415
2022-01-28,1118410,248636889,0,0,0,248636889
2022-02-07,947758,247886711,0,0,0,247886711
2022-02-08,892484,246763441,0,0,0,246763441
2022-02-09,1640139,245750632,0,0,0,245750632
2022-02-10,487012,245025217,0,0,0,245025217
2022-02-11,1470410,244792779,0,0,0,244792779
2022-02-14,1032601,242274529,0,0,0,242274529
2022-02-15,1587458,242726704,0,0,0,242726704
2022-02-16,3779857,243548584,0,0,0,243548584
2022-02-17,3025470,243488770,0,0,0,243488770
2022-02-18,3006861,243943766,0,0,0,243943766
2022-02-21,3412808,244056083,0,0,0,244056083
2022-02-22,3054724,244652151,0,0,0,244652151
2022-02-23,2695460,244408180,40000,40000,296800,244704980
2022-02-24,5522378,244636861,0,0,0,244636861
2022-02-25,5742379,247609759,0,0,0,247609759
2022-02-28,1957267,247629844,0,0,0,247629844
2022-03-01,2759377,248232835,0,0,0,248232835
2022-03-02,3918856,248692453,0,0,0,248692453
2022-03-03,2421190,245900722,0,0,0,245900722
2022-03-04,1998945,243311747,0,0,0,243311747
2022-03-07,1764046,242551061,59950,59950,437036,242988097
2022-03-08,5197116,245960897,40000,40000,287200,246248097
2022-03-09,5274519,244552750,0,40000,277200,244829950
2022-03-10,1366737,241413806,0,40000,280000,241693806
2022-03-11,3641867,242406766,0,40000,284000,242690766
2022-03-14,2362565,243366049,0,40000,276800,243642849
2022-03-15,2934176,243786992,0,40000,261600,244048592
2022-03-16,1725354,241863377,1100,1100,7425,241870802
2022-03-17,3209879,242138116,0,1100,7524,242145640
2022-03-18,870304,240213702,0,1100,7590,240221292
2022-03-21,1084735,239024384,400,1500,10395,239034779
2022-03-22,1636487,238581011,0,1500,10455,238591466
2022-03-23,343027,238074760,400,1900,13262,238088022
2022-03-24,1917948,238575159,0,1100,7524,238582683
2022-03-25,824465,236666477,0,0,0,236666477
2022-03-28,1313129,236948538,0,0,0,236948538
2022-03-29,1207274,237373883,0,0,0,237373883
2022-03-30,1484486,236769197,0,0,0,236769197
2022-03-31,2136002,235788858,500,500,3485,235792343
2022-04-01,1392010,235123338,0,500,3475,235126813
2022-04-06,1324322,234096773,0,500,3520,234100293
2022-04-07,1864666,233843690,0,500,3425,233847115
2022-04-08,2775472,234196694,0,500,3370,234200064
2022-04-11,2105740,233771038,0,500,3260,233774298
2022-04-12,1970338,233150615,0,0,0,233150615
2022-04-13,753696,232595677,0,0,0,232595677
2022-04-14,2273130,233319076,0,0,0,233319076
2022-04-15,2505063,233494014,0,0,0,233494014
2022-04-18,1393103,234317516,0,0,0,234317516
2022-04-19,1077988,234683565,0,0,0,234683565
2022-04-20,1303035,233585103,0,0,0,233585103
2022-04-21,2329549,228509865,0,0,0,228509865
2022-04-22,899528,225185381,0,0,0,225185381
2022-04-25,1894590,216159931,0,0,0,216159931
2022-04-26,1087526,209767786,0,0,0,209767786
2022-04-27,1364030,207278591,1100,1100,5929,207284520
2022-04-28,1764251,205738327,0,0,0,205738327
2022-04-29,516185,202582045,0,0,0,202582045
2022-05-05,1887294,202814344,0,0,0,202814344
2022-05-06,1509669,201103429,0,0,0,201103429
2022-05-09,307173,199481305,0,0,0,199481305
2022-05-10,2089654,200251894,0,0,0,200251894
2022-05-11,1961406,199753797,0,0,0,199753797
2022-05-12,1323272,200104919,0,0,0,200104919
2022-05-13,992658,199069763,0,0,0,199069763
2022-05-16,314488,198240660,0,0,0,198240660
2022-05-17,1609491,198381528,0,0,0,198381528
2022-05-18,721130,197239068,0,0,0,197239068
2022-05-19,751002,196933580,0,0,0,196933580
2022-05-20,899370,195977260,0,0,0,195977260
2022-05-23,4910312,198832365,101100,101100,618732,199451097
2022-05-24,4043621,199532761,400,400,2352,199535113
2022-05-25,1906673,198771502,400,800,4800,198776302
2022-05-26,1596777,197537440,0,800,4824,197542264
