日期,融资买入额(元),融资余额(元),融券卖出量,融券余量,融券余额(元),融资融券余额(元)
2017-07-12,11381018,574475458,0,36100,205770,574681228
2017-07-13,22051928,575410630,23600,59700,342678,575753308
2017-07-14,10595660,576320150,0,36700,210658,576530808
2017-07-17,15730223,574594789,59400,96100,542965,575137754
2017-07-18,6325847,571219689,0,36100,204687,571424376
2017-07-19,12248130,567828728,0,35100,201474,568030202
2017-07-20,21665772,571810167,0,33000,190740,572000907
2017-07-21,25952198,572138352,47700,75700,445873,572584225
2017-07-24,44279689,593789506,20400,88100,527719,594317225
2017-07-25,43524231,621520387,8000,44000,255640,621776027
2017-07-26,37620843,628555521,0,34000,195160,628750681
2017-07-27,26552467,636456133,0,33000,192720,636648853
2017-07-28,25635872,641591639,0,33000,190410,641782049
2017-07-31,21705567,648111236,0,33000,189750,648300986
2017-08-01,17587697,650831654,62500,95500,551990,651383644
2017-08-02,19407644,660848338,0,95500,541485,661389823
2017-08-03,22179621,651323447,0,85500,477945,651801392
2017-08-04,23825904,642334836,100,85600,476792,642811628
2017-08-07,11465368,639303831,0,85500,473670,639777501
2017-08-08,22049456,648712521,15700,101200,555588,649268109
2017-08-09,10951523,654837582,0,91200,500688,655338270
2017-08-10,8676465,658892121,0,91200,499776,659391897
2017-08-11,5422291,659826860,0,87900,479055,660305915
2017-08-14,24559925,680951919,0,87900,483450,681435369
2017-08-15,5558326,680046775,0,87900,483450,680530225
2017-08-16,7664290,680745633,0,87900,483450,681229083
2017-08-17,17280092,675357410,0,82100,451550,675808960
2017-08-18,6207629,674227317,0,82100,450729,674678046
2017-08-21,10479801,671166592,0,80100,440550,671607142
2017-08-22,24602461,683866061,153700,231800,1298080,685164141
2017-08-23,4117880,684225666,0,226500,1266135,685491801
2017-08-24,9335085,676566934,40600,216100,1207999,677774933
2017-08-25,4528381,668120940,44000,240100,1363768,669484708
2017-08-28,20268159,674831654,14000,250100,1435574,676267228
2017-08-29,13614150,678740060,33300,269400,1527498,680267558
2017-08-30,7376244,656781538,16300,250200,1431144,658212682
2017-08-31,10481465,607554377,9900,194500,1141715,608696092
2017-09-01,46192888,616841419,76200,195100,1164747,618006166
2017-09-04,14589747,610317635,43800,126300,755274,611072909
2017-09-05,55966646,617840235,159400,285700,1808481,619648716
2017-09-06,41213275,643230644,0,205700,1277397,644508041
2017-09-07,189701913,737948661,80000,207100,1414493,739363154
2017-09-08,81534233,718575931,98300,291800,1992994,720568925
2017-09-11,79584725,731329323,50600,244100,1694054,733023377
2017-09-12,56741611,684350019,14000,245800,1661608,686011627
2017-09-13,78137038,702086022,152900,381900,2730585,704816607
2017-09-14,198364188,791609470,83800,337000,2648820,794258290
2017-09-15,166681679,825214303,119000,377200,2881808,828096111
2017-09-18,107864013,842832438,57200,329900,2556725,845389163
2017-09-19,237616158,922549818,205800,500700,4145796,926695614
2017-09-20,85537859,915214441,83000,421000,3456410,918670851
2017-09-21,94477555,920999116,46300,383700,3008208,924007324
2017-09-22,35726245,887273936,145000,461200,3592748,890866684
2017-09-25,94089378,865382290,102500,348500,2460410,867842700
2017-09-26,32660498,821871779,138000,441200,3198700,825070479
2017-09-27,32488658,809527689,70600,399200,2914160,812441849
2017-09-28,38039317,812235485,25000,394300,2854732,815090217
2017-09-29,65912433,802561819,54800,333300,2333100,804894919
2017-10-09,92316790,782613477,180800,446000,3273640,785887117
2017-10-10,68537445,815608309,14600,289500,2093085,817701394
2017-10-11,73144462,832040680,45600,334100,2365428,834406108
2017-10-12,74724931,843885446,74100,293400,2021526,845906972
2017-10-13,77572777,872797810,23600,227400,1532676,874330486
2017-10-16,69306751,883898893,39200,211700,1399337,885298230
2017-10-17,28303752,870464873,8000,183700,1216094,871680967
2017-10-18,30954708,875456003,56200,224800,1499416,876955419
2017-10-19,48265926,899222875,0,216600,1416564,900639439
2017-10-20,51851060,901042030,92400,245000,1639050,902681080
2017-10-23,24474733,896982864,30500,188200,1259058,898241922
2017-10-24,71992985,877662756,484800,639500,4502080,882164836
2017-10-25,107898204,881401855,40900,425400,3126690,884528545
2017-10-26,40009602,867129293,36300,367900,2659917,869789210
2017-10-27,59063655,887882769,81900,398000,2861620,890744389
2017-10-30,56689978,868486405,44800,296600,2091030,870577435
2017-10-31,30473690,854165964,164300,445800,3214218,857380182
2017-11-01,65652161,858552123,188800,573500,4111995,862664118
2017-11-02,43495004,869048602,27100,245600,1674992,870723594
2017-11-03,28991393,879798662,19300,217800,1470150,881268812
2017-11-06,84150026,896330123,251900,429900,2678277,899008400
2017-11-07,36582553,901547872,15000,259500,1650420,903198292
2017-11-08,38378617,887621199,85000,264600,1664334,889285533
2017-11-09,43966425,887046167,54500,259100,1647876,888694043
2017-11-10,41321900,896319246,400,216100,1324693,897643939
2017-11-13,33727984,911752485,0,156100,963137,912715622
2017-11-14,40942738,918065257,132200,262900,1632609,919697866
2017-11-15,25898664,909111124,13000,173900,1086875,910197999
2017-11-16,51622654,894342598,288700,439600,2870588,897213186
2017-11-17,38374103,868350819,151400,388500,2509710,870860529
2017-11-20,22273559,859633059,132400,343300,2255481,861888540
2017-11-21,52225871,863825505,228500,510100,3453377,867278882
2017-11-22,62050634,855952807,42300,345300,2327322,858280129
2017-11-23,39550349,840059295,169700,403000,2651740,842711035
2017-11-24,40447534,855834877,43700,359200,2331208,858166085
2017-11-27,19584509,850133134,47000,327300,2101266,852234400
2017-11-28,34784184,859938711,60300,313700,1973173,861911884
2017-11-29,97641181,851285797,376700,616200,4264104,855549901
2017-11-30,76659420,860905089,8800,366400,2473200,863378289
2017-12-01,86725923,881952706,190500,439500,2979810,884932516
2017-12-04,38865225,876378143,79900,317200,2128412,878506555
2017-12-05,33186416,852613108,36600,297300,1974072,854587180
2017-12-06,34315158,858829053,44600,260100,1714059,860543112
2017-12-07,33542489,846631766,278900,539000,3568180,850199946
2017-12-08,31456991,851449326,65900,391400,2587154,854036480
2017-12-11,42144340,834958451,162600,494000,3393780,838352231
2017-12-12,46575040,829455007,75700,506700,3496230,832951237
2017-12-13,87649667,847305901,81500,483000,3405150,850711051
2017-12-14,57261728,849045217,42400,418700,2935087,851980304
2017-12-15,56465703,834503695,52300,389700,2685033,837188728
2017-12-18,26899282,812995190,17500,378300,2595138,815590328
2017-12-19,103071009,860640575,176000,456300,3280797,863921372
2017-12-20,63761458,853826604,29000,357200,2564696,856391300
2017-12-21,85479238,819487937,358500,678600,5035212,824523149
2017-12-22,57655313,828584287,0,525000,3890250,832474537
2017-12-25,61238806,756079138,264700,744700,5667167,761746305
2017-12-26,53644901,782545468,0,490700,3699878,786245346
2017-12-27,47586676,779851564,21600,459300,3499866,783351430
2017-12-28,36638674,785559000,58600,393200,2992252,788551252
2017-12-29,44654070,787615327,271850,575650,4530366,792145693
2018-01-02,122271705,796118412,118000,467550,3875990,799994402
2018-01-03,115384653,835158917,185350,558000,4659300,839818217
2018-01-04,75910284,811836311,61300,368650,3151958,814988269
2018-01-05,231523703,898267270,436470,729970,6299641,904566911
2018-01-08,203538046,917041844,62200,467570,4091238,921133082
2018-01-09,103450418,910493782,230900,581700,5072424,915566206
2018-01-10,75233593,904737995,31500,448600,3920764,908658759
2018-01-11,72903128,872999742,266900,649200,5745420,878745162
2018-01-12,92501109,828915755,139550,472350,4194468,833110223
2018-01-15,108359308,816145642,309100,678850,6028188,822173830
2018-01-16,164362946,840547692,135600,584100,5432130,845979822
2018-01-17,159865957,838401071,231700,637000,5580120,843981191
2018-01-18,126325488,866379714,88400,547700,4556864,870936578
2018-01-19,84800390,837074715,218400,614200,5220700,842295415
2018-01-22,126537981,871822362,137700,566200,4993884,876816246
2018-01-23,249831577,905116091,256700,721400,6997580,912113671
2018-01-24,232352954,944158963,96900,619200,6309648,950468611
2018-01-25,201921752,1011605570,146500,592800,5809440,1017415010
2018-01-26,202801329,1076185875,217300,590200,5996432,1082182307
2018-01-29,235754063,1096596683,210100,645200,6664916,1103261599
2018-01-30,191171411,1158241214,88000,528900,5125041,1163366255
2018-01-31,204757049,1172082587,257800,690000,6865500,1178948087
2018-02-01,201447188,1184556613,109800,505500,4958955,1189515568
2018-02-02,152667926,1131186455,287300,640400,6115820,1137302275
2018-02-05,76176948,1113205789,89000,581100,5607615,1118813404
2018-02-06,145237372,1081561261,214300,606500,5270485,1086831746
2018-02-07,191217704,1090556850,184300,565100,4458639,1095015489
2018-02-08,123891732,1116618536,173200,596000,4756080,1121374616
2018-02-09,91234514,1000909692,132900,439400,3308682,1004218374
2018-02-12,50094555,972116085,201200,564700,4399013,976515098
2018-02-13,105470686,977197624,249000,709500,5874660,983072284
2018-02-14,72830887,969024647,18700,412700,3454299,972478946
2018-02-22,83015379,989483746,114300,524300,4425092,993908838
2018-02-23,59509544,982726733,164200,639300,5427657,988154390
2018-02-26,76027746,991757851,112000,543400,4553692,996311543
2018-02-27,60139581,935017965,197900,657100,5401362,940419327
2018-02-28,80289683,896104061,152100,638700,5352306,901456367
2018-03-01,55472796,889771759,105000,609100,5000711,894772470
2018-03-02,48810701,891040525,85500,433400,3527876,894568401
2018-03-05,33493697,887268733,253000,592200,4802742,892071475
2018-03-06,115883943,896125831,228400,514200,4422120,900547951
2018-03-07,63066385,857211816,225500,653700,5602209,862814025
2018-03-08,67917994,858061478,180000,642200,5715580,863777058
2018-03-09,56054198,856954766,49300,578000,5086400,862041166
2018-03-12,86439205,855660169,65600,436400,3705036,859365205
2018-03-13,46722319,845816068,16400,317000,2662800,848478868
2018-03-14,58953012,872408077,351500,603100,5041916,877449993
2018-03-15,40948880,872963719,86900,385800,3209856,876173575
2018-03-16,44290192,862470767,139600,390500,3288010,865758777
2018-03-19,69212988,876501734,96143,299143,2417075,878918809
2018-03-20,36366114,878296466,242400,433700,3469600,881766066
2018-03-21,37261146,882051641,146400,448500,3592485,885644126
2018-03-22,34674043,878230748,200000,438600,3443010,881673758
2018-03-23,50671755,868895053,123600,379100,2759848,871654901
2018-03-26,50986829,896300234,116700,408100,2938320,899238554
2018-03-27,41476476,905110280,66300,333700,2436010,907546290
2018-03-28,29620348,901606396,288400,582300,4244967,905851363
2018-03-29,61301592,867604238,184500,375900,2950815,870555053
2018-03-30,53547371,876078853,70776,374476,2883465,878962318
2018-04-02,39197114,873038155,287066,540166,4218696,877256851
2018-04-03,35195903,888290692,51500,292700,2253790,890544482
2018-04-04,19853169,878069068,229700,466400,3586616,881655684
2018-04-09,15446965,863062285,30800,440800,3389752,866452037
2018-04-10,65859287,889119463,357900,566400,4525536,893644999
2018-04-11,54385084,872015316,125100,504800,4088880,876104196
2018-04-12,25135198,848909068,10000,350900,2856326,851765394
2018-04-13,25610841,844935129,200,347100,2797626,847732755
2018-04-16,94542326,890964895,78100,307400,2299352,893264247
2018-04-17,66105440,923402431,88800,315600,2307036,925709467
2018-04-18,39005524,927779265,30100,279600,2071836,929851101
2018-04-19,17865679,925301269,4200,204200,1517206,926818475
2018-04-20,19742485,921523825,25800,209900,1521775,923045600
2018-04-23,16802371,923407571,12300,210400,1538024,924945595
2018-04-24,36279399,919677799,264000,442500,3367425,923045224
2018-04-25,33492982,930852056,1400,318100,2373026,933225082
2018-04-26,24006777,934504635,300,318400,2321136,936825771
2018-04-27,24418148,925481663,4600,301400,2179122,927660785
2018-05-02,17741407,922113476,0,198400,1416576,923530052
2018-05-03,18440517,923283009,51600,218000,1567420,924850429
2018-05-04,17290598,914614900,80700,262100,1936919,916551819
2018-05-07,24172864,922071267,132800,282300,2108781,924180048
2018-05-08,23270444,910879809,61000,208700,1586120,912465929
2018-05-09,17794755,912872534,0,206700,1554384,914426918
2018-05-10,28485369,908384322,140000,251100,1865673,910249995
2018-05-11,24662712,915063490,72000,183100,1353109,916416599
2018-05-14,21544178,920441484,0,143500,1051855,921493339
2018-05-15,22194667,928300820,10000,153500,1126690,929427510
2018-05-16,12426931,914197905,0,153500,1128225,915326130
2018-05-17,30771817,929121679,171300,304800,2191512,931313191
2018-05-18,19969574,937383967,49900,245100,1764720,939148687
2018-05-21,25920751,940003961,0,135500,971535,940975496
2018-05-22,44549281,956783205,21600,66800,472944,957256149
2018-05-23,43224815,967283807,164600,210600,1442610,968726417
2018-05-24,29098475,977158483,0,96000,645120,977803603
2018-05-25,20356796,982919727,5200,79600,530136,983449863
2018-05-28,27698090,997602344,31200,90500,603635,998205979
2018-05-29,33309795,999408573,75800,130200,833280,1000241853
2018-05-30,19711560,998696493,17000,61700,381923,999078416
2018-05-31,32972337,997745903,104900,166600,1054578,998800481
2018-06-01,19911677,987913757,47500,98800,632320,988546077
2018-06-04,19259539,984875046,176600,222800,1463796,986338842
2018-06-05,29478668,995190245,0,36400,235872,995426117
2018-06-06,30716899,1001598885,0,36400,230412,1001829297
2018-06-07,31407062,1003027893,163900,199900,1307346,1004335239
2018-06-08,31365175,997834084,1900,91800,581094,998415178
2018-06-11,20178667,979219259,218600,308500,2023760,981243019
2018-06-12,22712623,982984324,1900,107600,704780,983689104
2018-06-13,23846689,985276298,91500,177200,1151800,986428098
2018-06-14,29161369,997300797,25800,99000,647460,997948257
2018-06-15,44531217,984368711,294900,346200,2295306,986664017
2018-06-19,87304259,1001927730,73800,140200,874848,1002802578
2018-06-20,25890210,1005987435,17000,108400,681836,1006669271
2018-06-21,24378897,967730528,147000,231000,1452990,969183518
2018-06-22,36822035,988313678,6900,78300,496422,988810100
2018-06-25,36770472,1002222341,7000,81300,499995,1002722336
2018-06-26,38120385,981576618,194000,245400,1469946,983046564
2018-06-27,28854721,978911200,35400,121400,718688,979629888
2018-06-28,42605379,996861369,41700,147800,869064,997730433
2018-06-29,19804745,1000936903,32800,140100,836397,1001773300
2018-07-02,20724850,964930142,85000,124400,721520,965651662
2018-07-03,17721589,968860534,7900,56500,327700,969188234
2018-07-04,5105662,955432775,14500,66200,379326,955812101
2018-07-05,13217543,957398230,65800,121500,687690,958085920
2018-07-06,14322201,947261606,41000,159400,900610,948162216
2018-07-09,10732938,945877541,33000,146900,850551,946728092
2018-07-10,19749696,938678335,153900,300800,1786752,940465087
2018-07-11,13921990,939943933,8200,176500,1014875,940958808
2018-07-12,28663095,946791188,18900,182200,1076802,947867990
2018-07-13,21192438,945340925,92888,196888,1167546,946508471
2018-07-16,12671807,944889087,42900,87400,506046,945395133
2018-07-17,8774358,943033621,21900,79400,459726,943493347
2018-07-18,9697742,943168661,29600,58600,334020,943502681
2018-07-19,6430674,938774759,34000,69900,396333,939171092
2018-07-20,12990580,933786699,48400,77400,447372,934234071
2018-07-23,22344241,929943537,109000,133515,810436,930753973
2018-07-24,30054313,928648549,122300,153315,939821,929588370
2018-07-25,22068705,936357308,32000,66515,407072,936764380
2018-07-26,24666304,944406236,65500,83015,494769,944901005
2018-07-27,11216845,943838801,26500,63515,381725,944220526
2018-07-30,16812066,945651809,33600,46115,279918,945931727
2018-07-31,16014368,944215413,73900,76015,465972,944681385
2018-08-01,53704589,959057690,116000,131015,782160,959839850
2018-08-02,53470291,990049765,115700,115715,688504,990738269
2018-08-03,10691391,990504327,51600,111715,643478,991147805
2018-08-06,10806226,989108020,38400,70415,398549,989506569
2018-08-07,12259193,992641900,66100,95715,557061,993198961
2018-08-08,7856828,992970871,18500,86215,488839,993459710
2018-08-09,8989493,985146791,132200,161915,939107,986085898
2018-08-10,21501578,986469940,114600,143615,851637,987321577
2018-08-13,17566833,991808228,28000,57015,330687,992138915
2018-08-14,13888696,991164647,15900,45515,258525,991423172
2018-08-15,4249964,982282328,29900,58915,333459,982615787
2018-08-16,9315445,985292154,132805,161820,907810,986199964
2018-08-17,13599004,984065489,29900,61815,343073,984408562
2018-08-20,5793707,979143882,19800,51715,292707,979436589
2018-08-21,14204630,983460090,30000,32915,186628,983646718
2018-08-22,7008708,980901817,0,5615,31612,980933429
2018-08-23,6274670,981395720,17500,20415,114936,981510656
2018-08-24,6152653,978627096,16400,19315,108937,978736033
2018-08-27,14452752,971700138,198100,198115,1158973,972859111
2018-08-28,9898525,965886315,8700,8715,51070,965937385
2018-08-29,11158551,963588478,61700,64615,383813,963972291
2018-08-30,9918727,964554489,34600,37515,217587,964772076
2018-08-31,22556450,961106506,169900,174615,1056421,962162927
2018-09-03,17496446,959309775,13300,18015,109171,959418946
2018-09-04,16962860,959928140,162700,167415,1024580,960952720
2018-09-05,29204534,964212581,29800,87215,512824,964725405
2018-09-06,13003207,962079163,29900,34615,200075,962279238
2018-09-07,10876058,951119347,54800,59515,349353,951468700
2018-09-10,10883157,934695762,122800,127515,765090,935460852
2018-09-11,11658876,934348795,8900,13615,81554,934430349
2018-09-12,10318503,940293549,6900,11615,69109,940362658
2018-09-13,15896882,936677934,1500,6215,36793,936714727
2018-09-14,10339796,922649689,83500,88215,533701,923183390
2018-09-17,15221536,891147610,10000,14715,86083,891233693
2018-09-18,13291756,870271581,9200,13915,82238,870353819
2018-09-19,22230301,807571130,270800,275515,1680642,809251772
2018-09-20,15234376,811286203,0,4815,29179,811315382
2018-09-21,29041656,801530744,209700,214415,1352959,802883703
2018-09-25,56342757,833876492,4400,89115,534690,834411182
2018-09-26,9301399,821514440,34600,39315,238642,821753082
2018-09-27,11531629,822779964,0,14015,83950,822863914
2018-09-28,13409655,819498478,80400,94415,562713,820061191
2018-10-08,17131239,821319404,78800,83900,479069,821798473
2018-10-09,6976959,823768371,0,65700,373176,824141547
2018-10-10,25203656,839386092,83700,148400,839944,840226036
2018-10-11,22564530,830432926,64400,64400,327796,830760722
2018-10-12,11344124,812984792,120600,134600,693190,813677982
2018-10-15,22035225,817702556,65300,94900,465010,818167566
2018-10-16,22657287,768662531,197000,197200,966280,769628811
2018-10-17,10993171,752171064,118100,225300,1106223,753277287
2018-10-18,10577779,747269807,41200,146800,714916,747984723
2018-10-19,29536639,730793480,199634,224234,1154805,731948285
2018-10-22,35764171,729081206,0,24600,129888,729211094
2018-10-23,26103620,735626999,104700,128800,654304,736281303
2018-10-24,15846483,722122395,89300,113400,576072,722698467
2018-10-25,10510060,716130902,144300,177700,920486,717051388
2018-10-26,23140879,712455430,98700,201100,1075885,713531315
2018-10-29,13991724,701925341,40600,98800,529568,702454909
2018-10-30,14958686,684187149,238600,298400,1635232,685822381
2018-10-31,11619181,680532205,0,60400,330388,680862593
2018-11-01,23371250,685933836,136000,179700,1000929,686934765
2018-11-02,34325509,688917301,98400,141100,788749,689706050
2018-11-05,6476772,685304212,12100,109800,604998,685909210
2018-11-06,12698368,688008627,109800,209600,1148608,689157235
2018-11-07,5160742,685214584,6000,56000,306320,685520904
2018-11-08,8614464,669307913,48400,104400,577332,669885245
2018-11-09,11139329,671946040,29600,55800,306342,672252382
2018-11-12,22293854,684022989,2500,55900,310245,684333234
2018-11-13,16934117,670010631,34300,86900,486640,670497271
2018-11-14,16435311,667610418,171900,228800,1297296,668907714
2018-11-15,8604289,671824768,30400,86900,492723,672317491
2018-11-16,15338364,655782053,87400,144000,820800,656602853
2018-11-19,38385844,670611567,123800,216400,1283252,671894819
2018-11-20,14741621,665777749,34000,157400,906624,666684373
2018-11-21,23045739,666581743,189683,192183,1145411,667727154
2018-11-22,9114615,662931439,110000,112583,667617,663599056
2018-11-23,11685843,658397368,37400,37483,214403,658611771
2018-11-26,3653876,651933926,130700,138283,804807,652738733
2018-11-27,2858728,650912811,29900,39983,232701,651145512
2018-11-28,16084313,657039309,129700,129783,773507,657812816
2018-11-29,10910773,660810321,42600,43083,248158,661058479
2018-11-30,5029813,651505995,32800,33283,194040,651700035
2018-12-03,38749255,666010644,120000,120083,695281,666705925
2018-12-04,28973914,685743923,46900,51983,293184,686037107
2018-12-05,5542010,678642980,159900,159983,903904,679546884
2018-12-06,6645746,678551167,32500,44283,247985,678799152
2018-12-07,1687244,672882543,132900,132983,744705,673627248
2018-12-10,23111354,674272091,161000,161083,877902,675149993
2018-12-11,42847167,704205528,159500,164683,928812,705134340
2018-12-12,11696650,660483345,26800,78683,440625,660923970
2018-12-13,24783022,644118810,160100,161983,936262,645055072
2018-12-14,9156468,643285813,29900,29983,171203,643457016
2018-12-17,16430179,645406544,43200,43283,243250,645649794
2018-12-18,15248477,642474825,145700,145783,804722,643279547
2018-12-19,19018302,655279008,130000,130083,715457,655994465
2018-12-20,3695941,654979182,20700,20783,113267,655092449
2018-12-21,27366448,664642472,106500,106583,568087,665210559
2018-12-24,10957081,668819122,50000,61383,322875,669141997
2018-12-25,14642484,667788691,126500,129483,670722,668459413
2018-12-26,9359950,669967421,1300,1583,8247,669975668
2018-12-27,18836579,677995073,29900,29983,155012,678150085
2018-12-28,5277454,661385290,119200,119283,619079,662004369
2019-01-02,8428046,665736159,18000,27183,139992,665876151
2019-01-03,7099614,664382368,7900,25983,134592,664516960
2019-01-04,7790214,656103395,25800,43883,233896,656337291
2019-01-07,11301227,659867750,2400,20400,109140,659976890
2019-01-08,2119557,657130209,0,18000,96120,657226329
2019-01-09,6183155,655471826,0,0,0,655471826
2019-01-10,8644386,659332351,0,0,0,659332351
2019-01-11,8355905,661936993,0,0,0,661936993
2019-01-14,3176328,660859158,0,0,0,660859158
2019-01-15,3342435,653870958,12900,12900,68241,653939199
2019-01-16,5035242,653255863,0,10000,53100,653308963
2019-01-17,4700985,648653522,0,10000,53100,648706622
2019-01-18,6954300,650188817,0,0,0,650188817
2019-01-21,7290856,650589259,0,0,0,650589259
2019-01-22,14957828,660632552,86200,86200,450826,661083378
2019-01-23,10703056,664867050,3300,3300,17061,664884111
2019-01-24,12999077,667001721,2900,6200,32178,667033899
2019-01-25,14967018,667317075,140000,140000,739200,668056275
2019-01-28,13963443,672393053,29600,29600,155992,672549045
2019-01-29,16105895,669101383,91500,121100,653940,669755323
2019-01-30,31951476,671849553,120023,149623,848362,672697915
2019-01-31,24757836,661100016,50000,79600,448148,661548164
2019-02-01,12143804,654308411,0,29600,167832,654476243
2019-02-11,25160084,662991631,0,0,0,662991631
2019-02-12,27439408,672942493,45500,45500,260260,673202753
2019-02-13,22624600,671393790,0,0,0,671393790
2019-02-14,20237231,676265724,0,0,0,676265724
2019-02-15,33838138,697368522,0,0,0,697368522
2019-02-18,31927504,690044333,164400,164400,974892,691019225
2019-02-19,33939343,685908738,35200,35200,206976,686115714
2019-02-20,50436010,710011303,224900,244900,1476747,711488050
2019-02-21,32618900,722616548,26300,79200,469656,723086204
2019-02-22,33059007,686061352,123700,123700,733541,686794893
2019-02-25,40652260,660845482,207900,207900,1307691,662153173
2019-02-26,66095844,658213462,43100,71000,455110,658668572
2019-02-27,52369864,639172391,279700,308100,2088918,641261309
2019-02-28,42735985,636017019,47500,81400,557590,636574609
2019-03-01,17841474,613684258,45300,73800,515124,614199382
2019-03-04,64479721,625549220,314100,336700,2451176,628000396
2019-03-05,37306372,588563625,48200,108900,848331,589411956
2019-03-06,47732913,577884719,39000,130400,1014512,578899231
2019-03-07,53202244,580067618,82000,137400,1019508,581087126
2019-03-08,44680086,580755476,5000,12600,87948,580843424
2019-03-11,29155510,576961050,72500,75600,548100,577509150
2019-03-12,39096438,580710597,7000,32600,241892,580952489
2019-03-13,49613280,561226179,116700,149300,1142145,562368324
2019-03-14,69087840,607703243,0,53600,397176,608100419
2019-03-15,42447424,564549975,348700,382300,3043108,567593083
2019-03-18,55702411,548237860,24900,154000,1325940,549563800
2019-03-19,82601965,572852795,167500,264700,2300243,575153038
2019-03-20,83347993,607860485,246300,356300,3053491,610913976
2019-03-21,58159104,635398161,100800,201900,1685865,637084026
2019-03-22,45725969,648075453,10000,55100,458432,648533885
2019-03-25,39694844,656706078,63400,96100,772644,657478722
2019-03-26,29480300,660205910,109800,183900,1458327,661664237
2019-03-27,34233115,647456825,46500,109600,876800,648333625
2019-03-28,52379008,669138059,0,52700,414749,669552808
2019-03-29,55379737,671092182,123800,144681,1208086,672300268
2019-04-01,95041579,679770820,148800,165700,1386909,681157729
2019-04-02,55381635,672403342,9500,73300,609123,673012465
2019-04-03,69785168,701188432,102900,169300,1411962,702600394
2019-04-04,67266626,734525396,1200,59800,493350,735018746
2019-04-08,70857464,770039095,128700,187300,1517130,771556225
2019-04-09,75689566,768432115,263600,400900,3379587,771811702
2019-04-10,49906132,766162986,0,140800,1165824,767328810
2019-04-11,57234061,785610274,256900,397700,3217393,788827667
2019-04-12,58032784,769360199,30500,255200,2003320,771363519
2019-04-15,43805622,765759715,51962,158762,1220880,766980595
2019-04-16,48844143,778462123,322400,429200,3291964,781754087
2019-04-17,51616867,793775398,44000,142500,1070175,794845573
2019-04-18,40276416,816728342,18000,149100,1122723,817851065
2019-04-19,38412387,833347837,25000,91400,688242,834036079
2019-04-22,79683619,864054437,153900,219800,1562778,865617215
2019-04-23,35906863,879578519,1700,70800,506220,880084739
2019-04-24,41023566,899233293,2700,71100,509076,899742369
2019-04-25,32212130,903846714,47000,90300,632100,904478814
2019-04-26,21851960,881951748,7100,77400,534834,882486582
2019-04-29,35621638,902205833,55100,89600,604800,902810633
2019-04-30,10975171,888140321,16500,56600,387144,888527465
2019-05-06,23754842,882474592,280600,314700,1988904,884463496
2019-05-07,16275564,870563977,249500,294400,1960704,872524681
2019-05-08,14394392,866299533,107900,230000,1538700,867838233
2019-05-09,11157357,863468592,24900,34900,226850,863695442
2019-05-10,19882628,854363370,138400,138400,936968,855300338
2019-05-13,22760959,859294592,91600,114000,775200,860069792
2019-05-14,18084016,865580075,3900,26300,174106,865754181
2019-05-15,14782617,864008931,14000,39300,266847,864275778
2019-05-16,8478392,859530044,32000,63300,437403,859967447
2019-05-17,16457888,858876835,9800,65100,436821,859313656
2019-05-20,17986968,867331018,41600,74300,484436,867815454
2019-05-21,14522130,865436487,12400,12400,81592,865518079
2019-05-22,15078339,872643897,11400,11400,74556,872718453
2019-05-23,15802160,875463855,10300,10300,65199,875529054
2019-05-24,12894524,881896298,11400,11400,70680,881966978
2019-05-27,14075869,889049167,7400,17800,112318,889161485
2019-05-28,16357820,893476798,0,2400,15192,893491990
2019-05-29,16374213,892535136,16400,18800,115996,892651132
2019-05-30,26599792,910347868,5900,8300,50713,910398581
2019-05-31,8621877,898339746,34300,38200,235694,898575440
2019-06-03,47044280,931066185,2900,29200,176368,931242553
2019-06-04,18867968,917913876,67900,94200,556722,918470598
2019-06-05,28830217,917901889,394500,469300,2919046,920820935
2019-06-06,35578276,921506451,9000,83800,513694,922020145
2019-06-10,27314092,915461223,329300,404100,2606445,918067668
2019-06-11,29820100,908937282,75000,171800,1139034,910076316
2019-06-12,16235851,912214671,95800,206800,1366948,913581619
2019-06-13,10548827,911076297,11000,131200,865920,911942217
2019-06-14,22855207,912722837,1300,109300,719194,913442031
2019-06-17,18068065,908362744,18100,118400,781440,909144184
2019-06-18,14888631,897317983,22700,117000,766350,898084333
2019-06-19,46268019,923627827,25100,135200,888264,924516091
2019-06-20,16398073,905211492,15500,139100,937534,906149026
2019-06-21,50135656,944937347,29900,150500,997815,945935162
2019-06-24,20703282,938790904,18500,126200,840492,939631396
2019-06-25,16302286,944175715,2900,116600,762564,944938279
2019-06-26,5606930,934824089,0,111600,726516,935550605
2019-06-27,8803748,932674599,9000,117700,769758,933444357
2019-06-28,10688723,931656685,39900,148600,962928,932619613
2019-07-01,15744562,912652175,19100,127800,866484,913518659
2019-07-02,22928974,922738264,4000,118800,814968,923553232
2019-07-03,42104976,924798110,230800,263200,1868720,926666830
2019-07-04,54142736,937240099,484400,603100,4384537,941624636
2019-07-05,30145765,939219010,9000,229700,1628573,940847583
2019-07-08,29189929,941359006,24200,58800,406308,941765314
2019-07-09,28051419,947432427,118200,151800,1044384,948476811
2019-07-10,22478287,944738108,10000,45600,311448,945049556
2019-07-11,27830299,951933672,18000,63600,429936,952363608
2019-07-12,29856712,960264148,25500,71100,478503,960742651
2019-07-15,28378443,968640306,76000,123100,802612,969442918
2019-07-16,43507566,971278573,312900,367500,2543100,973821673
2019-07-17,29662520,976807325,80600,195400,1352168,978159493
2019-07-18,19971283,985153552,11700,167900,1151794,986305346
2019-07-19,37900765,970374092,158200,224300,1628418,972002510
2019-07-22,43814215,950301813,150500,244900,1743688,952045501
2019-07-23,44882190,978028375,22300,103200,719304,978747679
2019-07-24,30158750,990470424,9000,89000,614100,991084524
2019-07-25,53111441,1020108009,173550,253550,1729211,1021837220
2019-07-26,36560421,1026393893,30000,111400,756406,1027150299
2019-07-29,23399786,1038101913,0,81400,550264,1038652177
2019-07-30,18559870,1026325313,11000,80900,559019,1026884332
2019-07-31,41870205,1016146600,85400,148600,982246,1017128846
2019-08-01,29162126,1031005786,11500,108800,712640,1031718426
2019-08-02,11255440,1017155981,11800,71400,460530,1017616511
2019-08-05,15312964,1016630558,87900,133700,846321,1017476879
2019-08-06,13643413,1002542908,85000,218200,1396480,1003939388
2019-08-07,44029310,1024230915,40200,145300,934279,1025165194
2019-08-08,8538973,1025398582,13000,103700,658495,1026057077
2019-08-09,19683434,1029933408,5000,99100,607483,1030540891
2019-08-12,5158515,1025362906,0,92500,581825,1025944731
2019-08-13,4150527,1023494369,7100,97600,609024,1024103393
2019-08-14,6988481,1023808865,40500,117500,734375,1024543240
2019-08-15,9556707,1021367573,26000,103500,651015,1022018588
2019-08-16,5675178,1017436694,0,103500,654120,1018090814
2019-08-19,25115461,1015645799,9000,107800,695310,1016341109
2019-08-20,19470216,1013043475,4800,112600,721766,1013765241
2019-08-21,11016836,1012538085,0,107800,683452,1013221537
2019-08-22,18476616,1020593468,5000,103800,642522,1021235990
2019-08-23,10158625,1015750169,0,98800,605644,1016355813
2019-08-26,16041308,1018889488,5000,103800,619686,1019509174
2019-08-27,21831509,1001423774,15200,108600,650514,1002074288
2019-08-28,11016354,1000911106,700,104300,616413,1001527519
2019-08-29,29737250,1016385592,12900,116500,675700,1017061292
2019-08-30,10092865,1002299830,2500,105300,600210,1002900040
2019-09-02,38187238,1024647895,21800,121800,706440,1025354335
2019-09-03,12395228,1028925007,0,99000,570240,1029495247
2019-09-04,16445121,1022350966,244000,339000,2037390,1024388356
2019-09-05,28832952,1019892418,54200,103500,621000,1020513418
2019-09-06,22543479,1022960753,0,72800,438256,1023399009
2019-09-09,18199970,1008012766,4000,65800,398748,1008411514
2019-09-10,41454206,1033804048,5700,67100,403942,1034207990
2019-09-11,11898890,1038363755,2000,64700,389494,1038753249
2019-09-12,42153113,1042774551,127100,176300,1082482,1043857033
2019-09-16,15190327,1038547411,8000,18600,114204,1038661615
2019-09-17,10843318,1033502090,5600,10400,62920,1033565010
2019-09-18,10329185,1022628357,162500,168900,1030290,1023658647
2019-09-19,17638241,1024466964,7100,14200,87330,1024554294
2019-09-20,8337894,1023637009,9000,16300,100082,1023737091
2019-09-23,13140036,1028376221,12000,17700,105846,1028482067
2019-09-24,15084603,1029500768,4000,9700,57715,1029558483
2019-09-25,9148560,1028729548,12800,22500,131400,1028860948
2019-09-26,18658369,1026834788,1000,12700,74549,1026909337
2019-09-27,5896544,1023017221,6700,19400,114072,1023131293
2019-09-30,5553720,1021385910,0,12100,71390,1021457300
2019-10-08,15530890,1002531639,324300,336400,2082316,1004613955
2019-10-09,19488575,966940653,39900,146300,943635,967884288
2019-10-10,10788587,942210829,62000,190000,1227400,943438229
2019-10-11,11035000,937809750,2000,58000,377580,938187330
2019-10-14,20488008,936929838,60000,106300,698391,937628229
2019-10-15,6578247,929977288,2400,58700,385659,930362947
2019-10-16,16436941,918018075,205800,258500,1731950,919750025
2019-10-17,12434238,919574182,0,46700,309154,919883336
2019-10-18,18781579,927440358,49300,74000,479520,927919878
2019-10-21,16962204,926719502,245000,269700,1771929,928491431
2019-10-22,8959403,928691020,9400,143600,949196,929640216
2019-10-23,4783599,921785148,77500,214300,1392950,923178098
2019-10-24,16460950,925903529,31500,238200,1567356,927470885
2019-10-25,21501265,935200138,800,99400,656040,935856178
2019-10-28,21806940,927720045,32400,123700,791680,928511725
2019-10-29,24016485,937227225,60000,127000,788670,938015895
2019-10-30,9141799,935781106,25600,112500,691875,936472981
2019-10-31,26093442,934149225,50000,152700,940632,935089857
2019-11-01,7421001,924215497,3100,77600,493536,924709033
2019-11-04,27854672,944526422,6500,74500,468605,944995027
2019-11-05,25249159,924708869,219400,291500,1923900,926632769
2019-11-06,19288236,902500215,166600,313500,2078505,904578720
2019-11-07,18263413,866295128,236200,398400,2760912,869056040
2019-11-08,14350761,867430555,129900,294600,1994442,869424997
2019-11-11,11873670,858306740,77300,260800,1726496,860033236
2019-11-12,15759996,862600107,4500,247200,1638936,864239043
2019-11-13,9430920,863452392,18100,207400,1343952,864796344
2019-11-14,8845692,863185181,0,158900,1026494,864211675
2019-11-15,13217053,869575646,31800,122800,779780,870355426
2019-11-18,13017375,865024464,84900,171900,1146573,866171037
2019-11-19,18742012,866197306,137700,256000,1768960,867966266
2019-11-20,18877087,869155251,7000,140900,945439,870100690
2019-11-21,7961007,863472940,0,78800,523232,863996172
2019-11-22,16897508,865596572,28800,80300,525965,866122537
2019-11-25,37579091,850543689,680000,744500,5367845,855911534
2019-11-26,35875157,863878132,0,248100,1709409,865587541
2019-11-27,13858638,848972540,185600,433700,3014215,851986755
2019-11-28,14151904,851788729,28700,306300,2119596,853908325
2019-11-29,12979569,851724632,182000,387700,2682884,854407516
2019-12-02,25975333,816949948,491900,837100,6135943,823085891
2019-12-03,27822261,795087834,122000,845100,6388956,801476790
2019-12-04,29519348,806049951,4200,611912,4479196,810529147
2019-12-05,26975258,809509279,43200,485900,3537352,813046631
2019-12-06,38049819,826362513,83200,520100,3822735,830185248
2019-12-09,27274339,799460479,508600,1003400,7856622,807317101
2019-12-10,13661235,780365102,40900,595300,4667152,785032254
2019-12-11,45963578,798661790,287700,813500,6385975,805047765
2019-12-12,52401026,807154596,50100,555800,4274102,811428698
2019-12-13,43534717,809641052,213000,653800,5099640,814740692
2019-12-16,49942011,819462871,31000,500800,3916256,823379127
2019-12-17,60550272,824816403,520300,966100,7641851,832458254
2019-12-18,18220117,820299907,43200,546600,4312674,824612581
2019-12-19,21639891,829162789,171400,714800,5689808,834852597
2019-12-20,38172321,834077753,345950,861350,7063070,841140823
2019-12-23,37002552,841027359,18400,567100,4536800,845564159
2019-12-24,30486809,855138105,35400,361800,2829276,857967381
2019-12-25,22482334,854548248,11000,340400,2661928,857210176
2019-12-26,43499387,834459750,471500,811900,6738770,841198520
2019-12-27,40109808,830318188,41300,544500,4552020,834870208
2019-12-30,28634479,795178372,66600,583700,4984798,800163170
2019-12-31,26642491,801719756,108900,627100,5330350,807050106
2020-01-02,27627462,773731730,41800,547300,4695834,778427564
2020-01-03,80828102,791696731,2600,386300,3217879,794914610
2020-01-06,45876242,788760378,31400,366000,2960940,791721318
2020-01-07,32558578,773626008,76000,432800,3561944,777187952
2020-01-08,50270060,796664330,5000,303400,2408996,799073326
2020-01-09,68954426,802118748,290700,591100,4799732,806918480
2020-01-10,34726544,818824536,79300,391900,3111686,821936222
2020-01-13,48802388,827745264,138800,460000,3680000,831425264
2020-01-14,27146739,800014136,6300,328900,2618044,802632180
2020-01-15,17207514,801008919,5000,272500,2144575,803153494
2020-01-16,14164300,796863695,11300,238100,1857180,798720875
2020-01-17,20637614,798647475,14000,240600,1888710,800536185
2020-01-20,18032927,786808225,3800,192800,1513480,788321705
2020-01-21,33684135,783719511,9200,182300,1354489,785074000
2020-01-22,13706306,761429252,8800,186500,1419265,762848517
2020-01-23,32214161,766625387,4000,162200,1162974,767788361
2020-02-03,38291710,779522223,0,153200,988140,780510363
2020-02-04,33279076,769168922,0,152600,1028524,770197446
2020-02-05,13030965,756360449,0,137600,919168,757279617
2020-02-06,26832403,763876422,0,137500,932250,764808672
2020-02-07,28583267,774780479,0,137200,912380,775692859
2020-02-10,19934976,769131498,0,137200,928844,770060342
2020-02-11,22282924,764504194,49900,183100,1289024,765793218
2020-02-12,27542457,776968974,4000,187100,1296603,778265577
2020-02-13,34825297,765904739,38000,221200,1574944,767479683
2020-02-14,39579841,746543441,180700,396800,3047424,749590865
2020-02-17,48413391,750573010,5300,296000,2282160,752855170
2020-02-18,40184916,751284309,47900,262400,2002112,753286421
2020-02-19,23608825,746815426,4000,266400,2040624,748856050
2020-02-20,37516249,734114356,59900,309300,2397075,736511431
2020-02-21,40322684,743031442,1000,172800,1299456,744330898
2020-02-24,32799153,750578493,4000,131000,962850,751541343
2020-02-25,37993851,689709202,156300,282300,2185002,691894204
2020-02-26,37489235,669995820,88900,239900,1923998,671919818
2020-02-27,20272961,668954877,5400,203300,1599971,670554848
2020-02-28,40118917,662209205,173300,360600,2888406,665097611
2020-03-02,48427670,667142850,75900,297800,2427070,669569920
2020-03-03,49416017,678577619,1700,171200,1367888,679945507
2020-03-04,53411743,678198456,168500,338300,2824805,681023261
2020-03-05,37794906,664306108,3000,205000,1705600,666011708
2020-03-06,30074806,672692057,1700,157800,1259244,673951301
2020-03-09,38093631,684841659,114800,259400,1948094,686789753
2020-03-10,31656913,665158662,4700,149300,1136173,666294835
2020-03-11,36017155,681592023,115000,259700,1921780,683513803
2020-03-12,26638603,681812128,66300,211000,1533970,683346098
2020-03-13,26542707,675123554,42000,192600,1371312,676494866
2020-03-16,30745709,680503297,4900,125800,865504,681368801
2020-03-17,12959133,671493613,6800,132600,925548,672419161
2020-03-18,11954772,662487302,31000,114500,764860,663252162
2020-03-19,33765892,670686279,110500,145000,932350,671618629
2020-03-20,13599242,673467757,55200,108300,726693,674194450
2020-03-23,13051177,677767045,500,83000,527880,678294925
2020-03-24,29334161,696571499,304500,376700,2429715,699001214
2020-03-25,50065915,708565769,114900,406100,2834578,711400347
2020-03-26,29377345,720532904,301800,627900,4307394,724840298
2020-03-27,36885698,704732195,199700,814600,5742930,710475125
2020-03-30,13557203,665867138,124200,811500,5802225,671669363
2020-03-31,29851050,673883949,400,683100,4774869,678658818
2020-04-01,11406017,670462775,36000,659700,4571721,675034496
2020-04-02,7761776,656092547,166400,783100,5520855,661613402
2020-04-03,12972168,660486590,0,782600,5486026,665972616
2020-04-07,19717816,663088302,16800,788600,5599060,668687362
2020-04-08,16236921,672429490,130000,916200,6468372,678897862
2020-04-09,14791340,675500996,2000,784200,5450190,680951186
2020-04-10,16863946,677286503,0,715800,4931862,682218365
2020-04-13,4480370,662929778,117200,833000,5864320,668794098
2020-04-14,7749592,652253720,59900,82700,603710,652857430
2020-04-15,11223576,655213119,33600,54500,388040,655601159
2020-04-16,12765470,660481915,129900,166900,1179983,661661898
2020-04-17,14519247,661873432,0,37000,263070,662136502
2020-04-20,30853623,684514410,64200,99200,687456,685201866
2020-04-21,13061097,689169002,17400,69500,470515,689639517
2020-04-22,9542039,690462612,502000,556200,3793284,694255896
2020-04-23,9745816,685454727,6000,536200,3646160,689100887
2020-04-24,10522597,687302386,29367,559567,3726716,691029102
2020-04-27,10921972,683313959,101000,642900,4346004,687659963
2020-04-28,19671357,688009099,147800,690700,4731295,692740394
2020-04-29,15775684,687358285,27500,710200,4950094,692308379
2020-04-30,16114762,692045612,7500,676100,4725939,696771551
2020-05-06,28414370,713250055,5900,657500,4510450,717760505
2020-05-07,25137640,729498413,12800,664400,4478056,733976469
2020-05-08,25071764,727933794,38400,637200,4396680,732330474
2020-05-11,22986529,713636889,228500,855300,6012759,719649648
2020-05-12,21428309,728033481,8000,737600,5067312,733100793
2020-05-13,14789720,724509415,10000,730300,5009858,729519273
2020-05-14,7442688,721049626,11300,615600,4149144,725198770
2020-05-15,24077861,721735033,9000,616300,4141536,725876569
2020-05-18,10354054,696674135,158100,264400,1858732,698532867
2020-05-19,24853950,709902443,15700,236200,1634504,711536947
2020-05-20,11914496,716452321,48300,163500,1110165,717562486
2020-05-21,13758552,723406532,9600,162400,1099448,724505980
2020-05-22,17326233,709891958,68700,228100,1496336,711388294
2020-05-25,8726715,710172099,43000,268000,1763440,711935539
2020-05-26,41165619,736496164,92000,249400,1661004,738157168
2020-05-27,6927229,719292364,102000,345800,2309944,721602308
2020-05-28,13133750,718969959,0,237700,1575951,720545910
2020-05-29,20508125,718498123,7400,220000,1427800,719925923
2020-06-01,17139192,702865356,29800,247200,1663656,704529012
2020-06-02,20767386,699974287,288400,480600,3320946,703295233
2020-06-03,14123402,696158358,46600,446000,3050640,699208998
2020-06-04,28027455,712608468,6500,451200,3063648,715672116
2020-06-05,21885200,717988209,0,441200,2978100,720966309
2020-06-08,10086634,708014164,81000,478700,3283882,711298046
2020-06-09,7850179,705607202,0,398700,2727108,708334310
2020-06-10,12211642,711931269,0,398700,2703186,714634455
2020-06-11,19775822,716675610,21100,418800,2789208,719464818
2020-06-12,4052245,712450548,35800,236900,1549326,713999874
2020-06-15,7328116,708577576,112600,323000,2093040,710670616
2020-06-16,9499291,713006153,0,316000,2060320,715066473
2020-06-17,10484364,715593994,7500,323500,2086575,717680569
2020-06-18,9792126,700675630,23700,256200,1683234,702358864
2020-06-19,14393548,705623652,0,252700,1667820,707291472
2020-06-22,23531592,719146853,0,252700,1637496,720784349
2020-06-23,30749007,735555636,0,252700,1624861,737180497
2020-06-24,17072133,728274240,80000,219100,1437296,729711536
2020-06-29,49102389,754726645,14400,137900,877044,755603689
2020-06-30,28852436,763072214,1300,127400,807716,763879930
2020-07-01,84230120,747868386,382800,507900,3540063,751408449
2020-07-02,70869184,732729714,10300,488600,3591210,736320924
2020-07-03,31667503,693234447,66200,416000,3103360,696337807
2020-07-06,82204757,704381068,55541,375041,2970325,707351393
2020-07-07,96299929,747823836,41700,329941,2507552,750331388
2020-07-08,48538513,741863127,39500,345641,2647610,744510737
2020-07-09,63611455,719711754,51000,362041,2769614,722481368
2020-07-10,46549830,726252570,3000,314041,2327044,728579614
2020-07-13,49585271,748677976,2400,310441,2315890,750993866
2020-07-14,43388850,722064753,3000,177300,1303155,723367908
2020-07-15,45708865,726521048,3700,178000,1278040,727799088
2020-07-16,23543644,717984510,56400,229200,1620444,719604954
2020-07-17,41371856,698458378,8000,140100,1050750,699509128
2020-07-20,74361830,730550789,107400,133100,986271,731537060
2020-07-21,63216167,757441078,2600,37800,274806,757715884
2020-07-22,39641331,759243048,4200,36800,265696,759508744
2020-07-23,31284078,765580390,68500,105300,743418,766323808
2020-07-24,43235793,764852984,239800,339100,2363527,767216511
2020-07-27,29776901,778144286,29500,361500,2476275,780620561
2020-07-28,14807080,774710415,193100,529700,3692009,778402424
2020-07-29,13780856,773111801,38700,545400,3823254,776935055
2020-07-30,32271619,780407742,8100,514800,3552120,783959862
2020-07-31,29790634,789378016,0,504800,3498264,792876280
2020-08-03,35736360,792199002,0,288900,2025189,794224191
2020-08-04,36076237,783232738,89500,363300,2568531,785801269
2020-08-05,36389657,791585383,0,39900,276108,791861491
2020-08-06,31530711,800616749,1400,34900,240810,800857559
2020-08-07,45826935,827900738,5600,40500,274185,828174923
2020-08-10,32650019,762741540,273100,305000,2205150,764946690
2020-08-11,41691951,775112778,54900,85500,595935,775708713
2020-08-12,21293630,770019590,141200,170500,1202025,771221615
2020-08-13,14134022,767297571,132100,298600,2105130,769402701
2020-08-14,55213056,777831983,84800,378000,2759400,780591383
2020-08-17,36356143,762700004,325000,702900,5215518,767915522
2020-08-18,27407842,758105771,22400,715600,5309752,763415523
2020-08-19,36934734,769016405,69800,672200,5021334,774037739
2020-08-20,29809482,769230064,1500,673700,5039276,774269340
2020-08-21,31492456,766442134,0,559400,4100402,770542536
2020-08-24,19603444,754933015,0,460500,3292575,758225590
2020-08-25,23500502,761028959,26800,487300,3464703,764493662
2020-08-26,24476450,759715663,94900,574000,4000780,763716443
2020-08-27,20780461,763300271,4000,485600,3374920,766675191
2020-08-28,16131080,758261173,96300,581900,4119852,762381025
2020-08-31,26316999,745941738,63500,555400,3915570,749857308
2020-09-01,32223594,751632710,0,494600,3442416,755075126
2020-09-02,24043316,754622740,40700,535300,3741747,758364487
2020-09-03,58855224,799434089,0,535300,3693570,803127659
2020-09-04,16139991,794170060,50000,581300,4022596,798192656
2020-09-07,27863831,796754638,94000,668300,4577855,801332493
2020-09-08,112202278,832930138,142800,536400,3620700,836550838
2020-09-09,135294997,775858631,379200,785700,5837751,781696382
2020-09-10,107336904,747235414,134900,711700,5814589,753050003
2020-09-11,112459916,670760274,678300,1325700,10380231,681140505
2020-09-14,59729873,652894376,200043,1285943,9901761,662796137
2020-09-15,43260298,649726923,43800,1066943,8066089,657793012
2020-09-16,71301140,657498001,816300,1858243,14735867,672233868
2020-09-17,26932214,650542506,75200,1675943,13022077,663564583
2020-09-18,76536939,696993072,305100,1799843,14182763,711175835
2020-09-21,58442965,680633943,408000,1965943,16042095,696676038
2020-09-22,33036338,685896714,44600,1811643,14456911,700353625
2020-09-23,22827688,665366561,201851,1660494,13001668,678368229
2020-09-24,14972294,623068666,46400,1077700,8233628,631302294
2020-09-25,20314225,615338691,84100,1111200,8267328,623606019
2020-09-28,27822387,601891757,83000,814400,6026560,607918317
2020-09-29,24454008,592484750,39700,691400,5033392,597518142
2020-09-30,17742937,589941010,19000,552900,4041699,593982709
2020-10-09,57390045,631313548,21500,553900,3949307,635262855
2020-10-12,62962518,661364904,45800,577400,4163054,665527958
2020-10-13,41814400,673684428,33600,515000,3666800,677351228
2020-10-14,28329104,674204550,127600,577400,4076444,678280994
2020-10-15,26827124,676146387,20000,593400,4219074,680365461
2020-10-16,29713619,686525036,58200,597900,4245090,690770126
2020-10-19,27343959,682602740,97600,658500,4695105,687297845
2020-10-20,33483871,683572168,9900,626000,4432080,688004248
2020-10-21,20502590,681621901,3500,613700,4332722,685954623
2020-10-22,13722434,671157274,0,613700,4369544,675526818
2020-10-23,19510595,655175325,2000,607700,4338978,659514303
2020-10-26,15366301,644146536,29000,576100,4101832,648248368
2020-10-27,17740460,644798513,56700,632800,4473896,649272409
2020-10-28,12210943,644139868,2000,632800,4442256,648582124
2020-10-29,13116943,643170403,0,593400,4171602,647342005
2020-10-30,26419677,640942341,80200,646600,4435676,645378017
2020-11-02,23026709,645887969,19000,665600,4625920,650513889
2020-11-03,19315967,648797378,4600,666200,4663400,653460778
2020-11-04,8939213,647482784,77000,723300,5041401,652524185
2020-11-05,23455706,643593958,81200,596100,4274037,647867995
2020-11-06,21872041,633893323,4400,527100,3810933,637704256
2020-11-09,23167579,631389831,3000,528100,3818163,635207994
2020-11-10,19366338,634052246,80700,605900,4326126,638378372
2020-11-11,19957011,607407643,91200,588000,4368840,611776483
2020-11-12,21491007,613580003,12400,482600,3566414,617146417
2020-11-13,15579128,609217887,100517,563617,4063679,613281566
2020-11-16,16880760,604801797,11000,483717,3579506,608381303
2020-11-17,23648509,597086770,91500,537317,4024504,601111274
2020-11-18,26567150,593445183,59600,585517,4385522,597830705
2020-11-19,23926457,598517844,500,513217,3818334,602336178
2020-11-20,15495838,597570636,0,482117,3533918,601104554
2020-11-23,27849691,605106555,113000,549317,4026494,609133049
2020-11-24,21918297,616485932,5100,554417,4025067,620510999
2020-11-25,38692910,631827131,0,549617,3940754,635767885
2020-11-26,29180151,647264988,2900,552517,3906295,651171283
2020-11-27,21751279,646842999,0,547717,3938085,650781084
2020-11-30,34426543,639837953,2800,521617,3745210,643583163
2020-12-01,39689488,644767490,8900,523117,3724593,648492083
2020-12-02,36625582,627213397,19200,457017,3336224,630549621
2020-12-03,26741772,635462137,73700,507017,3640382,639102519
2020-12-04,21267725,613148953,2000,509017,3639472,616788425
2020-12-07,46872450,643686119,8600,515517,3587998,647274117
2020-12-08,64304025,651308403,300,514817,3567682,654876085
2020-12-09,15025681,654203975,1100,515917,3549509,657753484
2020-12-10,13247306,661549596,18600,534517,3688167,665237763
2020-12-11,37391425,684116211,16200,550717,3772411,687888622
2020-12-14,10507730,686042545,0,545017,3749717,689792262
2020-12-15,10324737,682707924,134900,676317,4598956,687306880
2020-12-16,11412304,666535028,300000,957317,6461890,672996918
2020-12-17,27418528,671510708,4000,955317,6477049,677987757
2020-12-18,10306179,674224379,27400,982717,6603858,680828237
2020-12-21,9783751,655188317,24900,1007517,6760439,661948756
2020-12-22,13038782,653741806,32600,1037117,6927942,660669748
2020-12-23,17071947,640876232,0,1024317,6842438,647718670
2020-12-24,14049595,637968160,0,1024317,6719520,644687680
2020-12-25,67958224,684045654,0,1024317,6637574,690683228
2020-12-28,45854476,715584880,0,1010017,6413608,721998488
2020-12-29,17010846,719723271,0,986817,6345233,726068504
2020-12-30,17214518,723612529,51500,1038317,6655612,730268141
2020-12-31,8089702,715102751,0,1036717,6759395,721862146
2021-01-04,40763741,740113260,18300,1034717,6487676,746600936
2021-01-05,23584458,750502939,3600,1020017,6415907,756918846
2021-01-06,16896337,727010088,4200,1024217,6493536,733503624
2021-01-07,37959512,750370397,11500,1018617,6366356,756736753
2021-01-08,10520999,731053454,0,893417,5708935,736762389
2021-01-11,17602517,737664829,46300,939717,5854437,743519266
2021-01-12,7340979,733331555,12400,951817,5948856,739280411
2021-01-13,33978546,750596440,13600,925717,5804246,756400686
2021-01-14,17920364,741942679,53800,925617,5803619,747746298
2021-01-15,19296400,744518306,1600,914617,5716356,750234662
2021-01-18,35941737,700261685,36200,680517,4505023,704766708
2021-01-19,52491063,708580150,192800,841217,5636154,714216304
2021-01-20,20566414,704648426,0,701217,4649069,709297495
2021-01-21,33662934,715030183,0,701217,4536874,719567057
2021-01-22,14266294,706304216,14400,663617,4300238,710604454
2021-01-25,14347898,709671793,0,661217,4185504,713857297
2021-01-26,17442069,709724417,4400,653217,4049945,713774362
2021-01-27,11287979,708349535,4000,652817,4034409,712383944
2021-01-28,8750250,702123404,26400,678617,4112419,706235823
2021-01-29,10799247,690705970,4400,672617,4076059,694782029
2021-02-01,11447733,688042945,3400,666117,4049991,692092936
2021-02-02,13538092,687722040,4000,670117,4074311,691796351
2021-02-03,12813949,685918639,3600,669717,4078577,689997216
2021-02-04,40567667,711298549,13700,235917,1406065,712704614
2021-02-05,50714772,745359310,24100,253117,1531358,746890668
2021-02-08,20111069,739193164,0,236317,1432081,740625245
2021-02-09,11567773,731694476,4000,233017,1416743,733111219
2021-02-10,11239551,729303990,0,233017,1405093,730709083
2021-02-18,15470523,723933489,0,233017,1461017,725394506
2021-02-19,13176655,712681533,14000,231017,1469268,714150801
2021-02-22,20882508,708702829,12900,229817,1468531,710171360
2021-02-23,20931592,714587077,16700,242517,1525432,716112509
2021-02-24,9968001,707780007,200,238717,1511079,709291086
2021-02-25,66150047,725856453,154000,380617,2553940,728410393
2021-02-26,40649768,725576521,11700,323917,2063351,727639872
2021-03-01,21474868,725197258,4300,268417,1725921,726923179
2021-03-02,29340448,731796639,229700,497917,3146835,734943474
2021-03-03,8525727,720154876,33000,371217,2368364,722523240
2021-03-04,9145947,712556899,1800,342117,2162179,714719078
2021-03-05,17135384,709238197,32000,355817,2252322,711490519
2021-03-08,11076435,711876886,122900,434717,2743064,714619950
2021-03-09,21306436,716220347,33900,345717,2126160,718346507
2021-03-10,15383084,711875582,37000,353517,2145848,714021430
2021-03-11,12890491,659806496,23400,342717,2104282,661910778
2021-03-12,11777972,657501993,37000,343017,2136996,659638989
2021-03-15,73469468,718306377,55400,365417,2250969,720557346
2021-03-16,47133205,736643855,40700,302717,1946470,738590325
2021-03-17,28426566,752913228,44400,308917,1970890,754884118
2021-03-18,11170897,751865721,23500,318217,2052500,753918221
2021-03-19,19991983,759108000,84400,370717,2316981,761424981
2021-03-22,15353057,763785058,323300,681217,4271231,768056289
2021-03-23,12313148,755926106,38000,676317,4247271,760173377
2021-03-24,13506265,762351385,26000,678317,4191999,766543384
2021-03-25,9871092,766485235,20900,583217,3580952,770066187
2021-03-26,10417711,770566067,27900,611117,3758370,774324437
2021-03-29,18306960,679603531,44800,626917,3811655,683415186
2021-03-30,28294863,692331890,16900,626517,3809223,696141113
2021-03-31,9448096,694950043,3800,497600,3025408,697975451
2021-04-01,9812422,682140011,5100,500600,3088702,685228713
2021-04-02,16903653,689898547,1100,501700,3100506,692999053
2021-04-06,8441634,688354536,11000,501600,3099888,691454424
2021-04-07,8756621,685374512,11200,500700,3144396,688518908
2021-04-08,3476796,679515563,4000,501600,3135000,682650563
2021-04-09,10399764,679351018,22000,501600,3119952,682470970
2021-04-12,6614744,626474885,111600,584400,3705096,630179981
2021-04-13,19745164,641197411,118200,656400,4036860,645234271
2021-04-14,7653922,644106166,12100,663700,4095029,648201195
2021-04-15,14930262,630634063,155800,783000,4925070,635559133
2021-04-16,10990306,628191708,110000,817000,5187950,633379658
2021-04-19,31951639,635730228,27500,817500,5166600,640896828
2021-04-20,9307525,633785567,4800,822300,5172267,638957834
2021-04-21,9853629,627824645,5500,819200,5144576,632969221
2021-04-22,6584576,627058441,14200,815000,5101900,632160341
2021-04-23,9473146,622687633,9600,786600,4861188,627548821
2021-04-26,19305990,634460904,153700,935100,5722812,640183716
2021-04-27,48976968,667262405,40400,967400,5765704,673028109
2021-04-28,33252356,683488617,0,952000,5569200,689057817
2021-04-29,46539301,702996386,7900,898400,5156816,708153202
2021-04-30,30152701,688261379,99300,988000,5661240,693922619
2021-05-06,13340136,685393862,14000,922200,5238096,690631958
2021-05-07,9351831,687124160,1700,915300,5171445,692295605
2021-05-10,10194789,691659949,45800,951700,5320003,696979952
2021-05-11,8981019,687182810,81500,1029700,5786914,692969724
2021-05-12,11831176,692074423,1200,1021600,5669880,697744303
2021-05-13,8634291,685933133,7100,1024000,5724160,691657293
2021-05-14,10825337,687881762,12000,1015300,5695833,693577595
2021-05-17,10424282,685716286,179300,1194600,6701706,692417992
2021-05-18,76313138,744605588,8400,1180100,6750172,751355760
2021-05-19,14062310,745550224,159500,1333700,7495394,753045618
2021-05-20,9190284,747370922,4400,1239100,6877005,754247927
2021-05-21,16903372,747560953,17000,1057400,5847422,753408375
2021-05-24,12166371,748659246,80000,1108000,6138320,754797566
2021-05-25,21988616,757768167,84000,980200,5459714,763227881
2021-05-26,26163623,765289961,69200,1028000,5787640,771077601
2021-05-27,51952494,804715481,449624,1028524,5800875,810516356
2021-05-28,22698031,780289962,12200,1025324,5721308,786011270
2021-05-31,12399414,785764345,5000,1030324,5738905,791503250
2021-06-01,23612121,802626477,6800,1037124,5724924,808351401
2021-06-02,10858895,800549061,27500,1027624,5682761,806231822
2021-06-03,12862272,807246748,2200,948424,5225816,812472564
2021-06-04,6688239,803704439,14100,928424,5115616,808820055
2021-06-07,42259048,823478221,20000,897124,4790642,828268863
2021-06-08,26237571,842334803,72300,635300,3379796,845714599
2021-06-09,6828717,839715070,12700,510900,2687334,842402404
2021-06-10,5945401,842085116,1600,396800,2071296,844156412
2021-06-11,4324176,836675899,4600,400400,2094092,838769991
2021-06-15,11404384,842993356,98200,447500,2291200,845284556
2021-06-16,5234645,829280708,580600,1024700,5277205,834557913
2021-06-17,5197928,828485302,353700,1346900,6936535,835421837
2021-06-18,9312629,830553751,971200,2309200,11684552,842238303
2021-06-21,9519158,834278698,459600,2712000,13668480,847947178
2021-06-22,3364233,822902688,295400,2851800,14487144,837389832
2021-06-23,5636064,812716370,383500,3153900,16400280,829116650
2021-06-24,3239398,807333430,495200,3521400,18346494,825679924
2021-06-25,3069102,806168830,166200,3687600,19249272,825418102
2021-06-28,10061181,808314374,219635,3903235,20531016,828845390
2021-06-29,6835396,802874982,340300,4198035,22207605,825082587
2021-06-30,10312946,805464399,241500,4246435,22081462,827545861
2021-07-01,10228162,800092100,76200,3884300,20470261,820562361
2021-07-02,4552013,798600559,32300,3863400,20360118,818960677
2021-07-05,3670977,779147341,65146,3922746,19299910,798447251
2021-07-06,4341930,768830379,214900,4076846,20384230,789214609
2021-07-07,7295267,767677348,232500,4088546,20074761,787752109
2021-07-08,7537377,764550545,73100,4160946,20014150,784564695
2021-07-09,3441009,759373745,216700,4371646,20940184,780313929
2021-07-12,5213296,758012340,138415,4498361,21547149,779559489
2021-07-13,11420035,759874655,71000,4531461,21569754,781444409
2021-07-14,3340353,758764604,43900,4506861,21407590,780172194
2021-07-15,6937889,757083174,271100,4742957,22671335,779754509
2021-07-16,2120239,754968308,208500,4944957,23636895,778605203
2021-07-19,2830893,753919448,26400,4971357,23613946,777533394
2021-07-20,6391868,754634959,51000,5001357,23706432,778341391
2021-07-21,3466750,747532016,56800,5045307,23561584,771093600
2021-07-22,2758454,748445610,66800,5106607,24154252,772599862
2021-07-23,3359728,745672872,110900,5104507,23838048,769510920
2021-07-26,9244178,740462017,12700,5117007,22617170,763079187
2021-07-27,15394734,721009323,130100,5235307,22721233,743730556
2021-07-28,10237963,712850139,62400,5240407,22638559,735488698
2021-07-29,16447330,723375186,10300,5231107,22755316,746130502
2021-07-30,2338443,720701944,76500,5306307,23188563,743890507
2021-08-02,4047920,720347785,69700,5364607,23496978,743844763
2021-08-03,1086014,717311507,89800,5441007,23777202,741088709
2021-08-04,2871136,718534458,4200,5445107,23740667,742275125
2021-08-05,7174732,671865510,113000,5258207,23767096,695632606
2021-08-06,31132398,692460760,256600,5495407,24729332,717190092
2021-08-09,40571723,718720124,51900,5527007,25147882,743868006
2021-08-10,13332191,725174103,26100,5197807,23390132,748564235
2021-08-11,33910861,718679291,96300,5018607,23336523,742015814
2021-08-12,22058003,724023099,250550,5216357,23995243,748018342
2021-08-13,13440097,715685220,22500,5235557,23507651,739192871
2021-08-16,5838282,713376424,43900,5171057,23424888,736801312
2021-08-17,22272324,708457567,49700,4993557,22670749,731128316
2021-08-18,21381366,715599495,311584,5275941,24216570,739816065
2021-08-19,6746957,710683844,57300,5268241,23917814,734601658
2021-08-20,6319294,709259635,91500,5352741,23980279,733239914
2021-08-23,14407572,718023194,135000,5424941,23815491,741838685
2021-08-24,10495834,721668672,11600,5276457,22794295,744462967
2021-08-25,6685029,718376872,10300,5174757,22458446,740835318
2021-08-26,6286804,712087658,16800,5058161,22104165,734191823
2021-08-27,2866059,709088325,150200,5201561,22730823,731819148
2021-08-30,10551181,711514045,148700,5350161,23005693,734519738
2021-08-31,3044445,702272747,100600,5429561,24107251,726379998
2021-09-01,26771326,703755241,94900,5511361,25131806,728887047
2021-09-02,22011073,680761657,344600,5631361,27086847,707848504
2021-09-03,13350067,681335943,20900,5630861,26633973,707969916
2021-09-06,11622315,681089074,69400,5681661,26646990,707736064
2021-09-07,6035908,677924703,6100,5347961,25135417,703060120
2021-09-08,11740239,679431084,4600,5318761,24998177,704429261
2021-09-09,17574644,678772990,46800,5286561,24582509,703355499
2021-09-10,21937483,680344919,5600,5082991,23839228,704184147
2021-09-13,18167458,673818746,211400,5227091,24776411,698595157
2021-09-14,11487692,667560894,73600,5197591,23752992,691313886
2021-09-15,9401559,668632607,26800,5072191,22723415,691356022
2021-09-16,15124124,677053985,41400,4871391,20995696,698049681
2021-09-17,9529751,679312946,659900,5519991,23625561,702938507
2021-09-22,49822782,715598119,36400,5504891,22900346,738498465
2021-09-23,24608826,710816374,144900,5582291,24394613,735210987
2021-09-24,15619327,672365769,1300,4731091,20296381,692662150
2021-09-27,16715742,646129284,421300,5096291,20690942,666820226
2021-09-28,17411800,636529268,114300,5067291,21688005,658217273
2021-09-29,17882648,644594415,18100,4776091,19868538,664462953
2021-09-30,12317201,643154910,278000,5040291,21018014,664172924
2021-10-08,6622410,635533480,31400,5042491,21128038,656661518
2021-10-11,6786106,632710163,5900,4817791,20282900,652993063
2021-10-12,14737107,637563802,1600,4717861,19956552,657520354
2021-10-13,5368681,633081649,263000,4980261,20867294,653948943
2021-10-14,4937868,631138156,216600,5196761,21722461,652860617
2021-10-15,8015562,629570330,79000,5274761,21626521,651196851
2021-10-18,13381277,616257727,444600,5717061,22696733,638954460
2021-10-19,13846307,619799803,7000,5685061,22171738,641971541
2021-10-20,10818343,622810681,25400,5710161,21869917,644680598
2021-10-21,18431749,631388731,14200,5700461,22288803,653677534
2021-10-22,10944190,619630846,46000,5686061,22516801,642147647
2021-10-25,6235583,609184895,30500,5665361,21981600,631166495
2021-10-26,11847198,605637653,37800,5693861,21636672,627274325
2021-10-27,7363941,602458579,72000,5764561,21386522,623845101
2021-10-28,5816402,598004915,22855,5688916,20366320,618371235
2021-10-29,18064201,583969057,0,5607316,18055557,602024614
2021-11-01,36674704,569621476,245938,5818954,17340483,586961959
2021-11-02,31594887,553620244,709700,6528654,18149658,571769902
2021-11-03,26774578,563639634,25900,6466254,17652874,581292508
2021-11-04,12672284,548163327,6800,6316254,17243374,565406701
2021-11-05,29437305,550435162,201400,6309454,16846243,567281405
2021-11-08,10562989,539833758,12600,6203754,16564024,556397782
2021-11-09,20501095,549064688,4800,5974154,15771767,564836455
2021-11-10,14479270,541588458,14400,5936254,16146611,557735069
2021-11-11,25130904,542685870,207000,5998354,17935079,560620949
2021-11-12,67995185,555841806,706400,6701154,20237485,576079291
2021-11-15,48383625,569015661,141700,6561054,19223889,588239550
2021-11-16,19505799,560228593,5900,6230454,17881403,578109996
2021-11-17,20796039,557097136,500,6084154,17218156,574315292
2021-11-18,14384845,545027671,9200,5677754,15613824,560641495
2021-11-19,44197585,540124988,371400,5947254,17960707,558085695
2021-11-22,39317017,549970026,192200,5864754,16949139,566919165
2021-11-23,31296697,552212011,366200,6054854,18043465,570255476
2021-11-24,28488874,550809593,313100,6155454,18958798,569768391
2021-11-25,14991869,549150084,6100,5826754,17596797,566746881
2021-11-26,14256866,537428854,46700,5195604,15586812,553015666
2021-11-29,14922820,535250095,383800,5031404,14792328,550042423
2021-11-30,17157854,540470621,41200,4691604,13605652,554076273
2021-12-01,19254660,533061448,26100,3844560,11533680,544595128
2021-12-02,16772422,532067405,96600,3118408,9261672,541329077
2021-12-03,25729625,538557749,95700,2654708,7804841,546362590
2021-12-06,18948130,535561553,80900,2082308,6080340,541641893
2021-12-07,88715978,554335890,577400,2371308,7422194,561758084
2021-12-08,51938079,566371548,89800,2265308,6909190,573280738
2021-12-09,29383110,553707851,78500,2251208,6956232,560664083
2021-12-10,56139425,572467619,89100,2198008,6923725,579391344
2021-12-13,36138540,577558986,28900,2063508,6376239,583935225
2021-12-14,15452776,574738856,9900,2027308,6163017,580901873
2021-12-15,22167473,565348691,547300,2491808,7724605,573073296
2021-12-16,16466923,553963028,449000,2331908,7275553,561238581
2021-12-17,18777795,555140487,290100,2529008,7890505,563030992
2021-12-20,45201868,552198075,709200,3108608,10009717,562207792
2021-12-21,109786788,608727492,304600,3363108,11905402,620632894
2021-12-22,141472552,523386008,1158900,4385008,15215978,538601986
2021-12-23,52983955,511960068,412300,4347208,14476203,526436271
2021-12-24,32107317,497991055,323700,4365708,14144894,512135949
2021-12-27,43524358,499727182,466300,4694708,16102848,515830030
2021-12-28,58487533,510460425,2050700,6434208,20332097,530792522
2021-12-29,30290339,516305344,360800,6425908,19470501,535775845
2021-12-30,27083860,525769596,533200,6351693,19118596,544888192
2021-12-31,21975953,522514905,279300,6555793,19798495,542313400
2022-01-04,34669125,515758122,390700,6619093,20386806,536144928
2022-01-05,36047154,506127237,401601,6672594,20818493,526945730
2022-01-06,44779444,517510833,672400,6834393,21323306,538834139
2022-01-07,69566024,529969182,1599200,6998593,22745427,552714609
2022-01-10,84717103,565932686,1162100,7050093,23617812,589550498
2022-01-11,101656543,585434235,659400,6724693,21922499,607356734
2022-01-12,39948105,589420127,268000,6245993,20299477,609719604
2022-01-13,38326978,577600138,333900,6394493,20846047,598446185
2022-01-14,49668534,581493338,313000,6123593,19044374,600537712
2022-01-17,15634128,568767383,91400,5795393,18023672,586791055
2022-01-18,40756797,570039760,359800,5859893,18048470,588088230
2022-01-19,21024308,558073119,275700,5679093,18002725,576075844
2022-01-20,58409197,561278214,357300,4881393,15425202,576703416
2022-01-21,29310240,538263540,86000,4427493,13680953,551944493
2022-01-24,31791668,552401801,133000,4220193,12998194,565399995
2022-01-25,35885519,548914309,528170,4525827,13170157,562084466
2022-01-26,14982678,542317160,231600,4582863,13519446,555836606
2022-01-27,24968422,544540925,277700,4719121,13685451,558226376
2022-01-28,19782840,533219092,46100,4583621,13200829,546419921
2022-02-07,35892651,516878355,273000,4850721,12611875,529490230
2022-02-08,14604225,505467919,399100,4938421,13432505,518900424
2022-02-09,40522662,500124716,389400,3670821,10425132,510549848
2022-02-10,11922238,491357790,461700,3720921,10455788,501813578
2022-02-11,23107256,487703268,454700,3910821,10989407,498692675
2022-02-14,12739382,484736027,105400,3326821,9048953,493784980
2022-02-15,14631622,491587192,1702500,4941221,13193060,504780252
2022-02-16,10787316,492757604,175200,5051921,13539148,506296752
2022-02-17,13095347,494721450,520100,5203821,13686050,508407500
2022-02-18,12129098,488170756,588700,5437021,14625586,502796342
2022-02-21,21625690,490570824,707200,5628621,15309849,505880673
2022-02-22,11265840,485518471,221100,5359321,14202201,499720672
2022-02-23,12018195,484670901,319800,5490421,14439808,499110709
2022-02-24,23166168,493871224,540600,5563821,14076467,507947691
2022-02-25,8689705,489046435,281200,5624121,14172784,503219219
2022-02-28,15925506,487957151,203300,5253121,12712552,500669703
2022-03-01,8340418,484325148,160900,5114921,12429258,496754406
2022-03-02,7115773,482127203,255300,5008121,12319978,494447181
2022-03-03,6314913,476607761,305000,4700521,11751303,488359064
2022-03-04,8093835,472152696,222500,4429321,10851837,483004533
2022-03-07,12264779,470520223,205300,4188421,10177863,480698086
2022-03-08,10782286,465982334,433700,4292921,10002506,475984840
2022-03-09,9460930,457964211,380400,4391521,9793091,467757302
2022-03-10,4431178,448874554,205400,4223921,9503823,458378377
2022-03-11,3703425,439814687,267300,3980163,9154375,448969062
2022-03-14,7520559,439506977,227600,3910263,8641682,448148659
2022-03-15,6265951,408817569,596100,3545063,7302830,416120399
2022-03-16,5156574,399863854,398400,3740163,8041351,407905205
2022-03-17,12927247,400698407,32800,3758363,8907320,409605727
2022-03-18,50192580,411676038,1726600,4636463,12101169,423777207
2022-03-21,102850487,396997668,972400,5351963,15360134,412357802
2022-03-22,57385144,381319954,510100,5751963,18176203,399496157
2022-03-23,131571964,441342649,412300,5957563,20732320,462074969
2022-03-24,269576278,468564255,1386500,6526563,24996736,493560991
2022-03-25,236296531,399216186,1004700,7170763,27679145,426895331
2022-03-28,337118247,572042917,111900,7007363,29781293,601824210
2022-03-29,186145859,511312057,2161653,9053163,34673614,545985671
2022-03-30,282801098,505737294,236200,7853063,30312823,536050117
2022-03-31,256398297,499984428,1168700,8073463,34312218,534296646
2022-04-01,353039300,592632070,800400,7916663,30874986,623507056
2022-04-06,248751177,614099952,807900,8543463,30671032,644770984
2022-04-07,188341495,539907225,326500,7916263,29290173,569197398
2022-04-08,236041799,640398086,812500,8466763,31581026,671979112
2022-04-11,80707339,573616591,352200,7901263,26548243,600164834
2022-04-12,108754754,526960265,1045600,8491263,25643614,552603879
2022-04-13,94134417,539559682,286300,7024429,20300600,559860282
2022-04-14,59137114,512198497,1959100,8627929,25624949,537823446
2022-04-15,83199501,530415633,455100,7636529,22222300,552637933
2022-04-18,47159573,480036173,1049900,7634729,21224547,501260720
2022-04-19,40984036,489776785,319800,7381829,21185849,510962634
2022-04-20,28209822,469038651,429800,7430229,20284525,489323176
2022-04-21,25341000,464604866,358200,7451029,19298165,483903031
2022-04-22,18861629,457515467,191100,5746429,14998180,472513647
2022-04-25,55127015,473543412,1302099,6811728,16620617,490164029
2022-04-26,34692903,451681161,788800,7378428,18888775,470569936
2022-04-27,25975191,445786188,1214000,7969328,19923321,465709509
2022-04-28,69021833,479280158,875400,8485128,21382521,500662679
2022-04-29,87324455,476685745,361900,6566829,16942419,493628164
2022-05-05,65886429,489984177,1116800,7080429,17771877,507756054
2022-05-06,48798457,458385003,619900,6200929,14324146,472709149
2022-05-09,18275909,438953417,128300,5788829,14703626,453657043
2022-05-10,73556408,438525460,501700,5929629,15594925,454120385
2022-05-11,47482411,434058803,429300,5811429,14761030,448819833
2022-05-12,23496299,408163419,750700,6374029,15616372,423779791
2022-05-13,54196394,417546160,628000,6844329,17384596,434930756
2022-05-16,47535158,408168111,164300,6617929,16941898,425110009
2022-05-17,26485454,400184804,179900,6648029,16487113,416671917
2022-05-18,18758472,400079865,296700,6321429,15487502,415567367
2022-05-19,35357763,396301683,470300,6146029,15610914,411912597
2022-05-20,37779022,401364201,255900,6309029,15646393,417010594
2022-05-23,12552817,397439001,247900,6269229,15359612,412798613
2022-05-24,31472118,396455747,131400,5835829,13772556,410228303
2022-05-25,11294741,396899366,162800,5353829,12635036,409534402
2022-05-26,37359908,389158971,344000,5432629,13472921,402631892
