日期,融资买入额(元),融资余额(元),融券卖出量,融券余量,融券余额(元),融资融券余额(元)
2018-04-16,15201311,11376232,0,0,0,11376232
2018-04-17,15084476,23892503,0,0,0,23892503
2018-04-18,31646775,41539103,0,0,0,41539103
2018-04-19,64734464,77700442,0,0,0,77700442
2018-04-20,43499223,72725971,0,0,0,72725971
2018-04-23,45370241,95681433,0,0,0,95681433
2018-04-24,84149329,119247878,0,0,0,119247878
2018-04-25,48283709,131038313,0,0,0,131038313
2018-04-26,61026116,147179323,0,0,0,147179323
2018-04-27,41719452,141241061,0,0,0,141241061
2018-05-02,95585371,186238060,0,0,0,186238060
2018-05-03,75378361,200793674,0,0,0,200793674
2018-05-04,62700097,197441703,0,0,0,197441703
2018-05-07,43699699,211528729,0,0,0,211528729
2018-05-08,55841658,200673279,50000,50000,356500,201029779
2018-05-09,52690900,210429238,0,50000,347000,210776238
2018-05-10,27139975,206328970,0,50000,352000,206680970
2018-05-11,72281534,228528688,130000,140000,1002400,229531088
2018-05-14,53881872,241283394,0,140000,992600,242275994
2018-05-15,46382450,244962283,0,40000,284400,245246683
2018-05-16,38487291,236306502,0,40000,276800,236583302
2018-05-17,69965191,262554829,90000,130000,900900,263455729
2018-05-18,46690451,270728078,0,70000,474600,271202678
2018-05-21,64206818,300035912,0,70000,480900,300516812
2018-05-22,35134921,299692350,0,70000,473200,300165550
2018-05-23,31821508,293799937,0,70000,451500,294251437
2018-05-24,40767683,316489482,0,70000,454300,316943782
2018-05-25,13185246,311198732,0,70000,444500,311643232
2018-05-28,37514053,329363193,0,70000,443100,329806293
2018-05-29,51341056,345510018,200000,200000,1324000,346834018
2018-05-30,42509148,349306951,70000,200000,1294000,350600951
2018-05-31,38314704,357159388,0,200000,1318000,358477388
2018-06-01,67004989,362171433,70000,150000,1005000,363176433
2018-06-04,65915574,384378696,0,150000,1015500,385394196
2018-06-05,34787196,385709616,0,150000,1015500,386725116
2018-06-06,24798064,368160633,0,150000,1015500,369176133
2018-06-07,70220954,379389317,120000,150000,1045500,380434817
2018-06-08,32280068,379177340,120000,150000,1029000,380206340
2018-06-11,53115822,384861736,70000,150000,1051500,385913236
2018-06-12,48019778,375001041,0,150000,1072500,376073541
2018-06-13,76386669,391011870,120000,150000,1068000,392079870
2018-06-14,109086651,388362413,120000,200000,1470000,389832413
2018-06-15,95385724,388566192,0,100000,726000,389292192
2018-06-19,121818099,403241594,0,100000,656000,403897594
2018-06-20,59719467,384279659,170000,200000,1378000,385657659
2018-06-21,138577707,430969075,0,200000,1398000,432367075
2018-06-22,154378720,443908902,70000,200000,1440000,445348902
2018-06-25,68848174,433596030,0,200000,1408000,435004030
2018-06-26,90085601,417351961,0,200000,1350000,418701961
2018-06-27,58746781,411311788,0,200000,1300000,412611788
2018-06-28,34067176,408375858,0,200000,1280000,409655858
2018-06-29,53627422,414041317,0,200000,1312000,415353317
2018-07-02,34300761,389722839,0,200000,1274000,390996839
2018-07-03,29497359,398757206,0,200000,1272000,400029206
2018-07-04,60203137,405371317,0,200000,1286000,406657317
2018-07-05,44229571,385051420,0,200000,1240000,386291420
2018-07-06,45391361,393784971,70000,155000,967200,394752171
2018-07-09,40529881,389591864,0,155000,998200,390590064
2018-07-10,77876302,404751736,45000,200000,1326000,406077736
2018-07-11,54990900,398524599,0,200000,1310000,399834599
2018-07-12,76214149,371844166,70000,110000,737000,372581166
2018-07-13,45182047,367669414,160000,200000,1336000,369005414
2018-07-16,35199900,382331766,0,200000,1322000,383653766
2018-07-17,45360279,389770771,70000,200000,1290000,391060771
2018-07-18,29083980,395912410,0,200000,1276000,397188410
2018-07-19,35108313,378663740,70000,200000,1292000,379955740
2018-07-20,60864223,375631590,70000,200000,1306000,376937590
2018-07-23,89319533,372706630,70000,110000,751300,373457930
2018-07-24,103588260,357663025,160000,200000,1456000,359119025
2018-07-25,171363843,410058450,70000,110000,843700,410902150
2018-07-26,123287187,400179252,160000,200000,1564000,401743252
2018-07-27,103558143,373697016,70000,110000,860200,374557216
2018-07-30,129855479,404231114,70000,80000,628000,404859114
2018-07-31,122230828,430331251,30000,110000,850300,431181551
2018-08-01,144668642,450771476,90000,200000,1462000,452233476
2018-08-02,100635472,453928914,70000,155000,1150100,455079014
2018-08-03,48205566,398472381,45000,200000,1502000,399974381
2018-08-06,88346930,435108070,70000,100000,740000,435848070
2018-08-07,122693708,446945575,70000,100000,791000,447736575
2018-08-08,129363082,441250297,170000,200000,1594000,442844297
2018-08-09,151723353,486663013,70000,200000,1654000,488317013
2018-08-10,91581401,482639447,70000,110000,902000,483541447
2018-08-13,99679207,486587167,70000,110000,933900,487521067
2018-08-14,135188337,499717190,60600,170000,1394000,501111190
2018-08-15,93793463,492876168,22000,132000,1061280,493937448
2018-08-16,70474604,500022598,0,132000,1050720,501073318
2018-08-17,80275104,479813021,170000,232000,1879200,481692221
2018-08-20,90959881,476836606,0,187000,1583890,478420496
2018-08-21,82916738,469663515,0,177000,1474410,471137925
2018-08-22,77320149,475378272,0,177000,1465560,476843832
2018-08-23,111311358,479461017,102400,222000,1787100,481248117
2018-08-24,57787968,484639235,0,177000,1400070,486039305
2018-08-27,62942785,492733486,0,177000,1421310,494154796
2018-08-28,81921926,528747232,75000,197000,1568120,530315352
2018-08-29,66397444,526233246,60000,187000,1458600,527691846
2018-08-30,90772677,527789204,55000,242000,1785960,529575164
2018-08-31,43035311,520703814,0,232000,1686640,522390454
2018-09-03,58043763,534785024,0,232000,1672720,536457744
2018-09-04,73953602,553917492,10000,197000,1447950,555365442
2018-09-05,71176246,542485134,10000,197000,1379000,543864134
2018-09-06,35860540,551638544,0,142000,1001100,552639644
2018-09-07,46591599,528200464,46300,166300,1192371,529392835
2018-09-10,45898848,535197592,55000,165000,1171500,536369092
2018-09-11,148532461,580999490,135000,220000,1416800,582416290
2018-09-12,34829207,563240278,10000,210000,1329300,564569578
2018-09-13,49847415,577692426,80000,210000,1333500,579025926
2018-09-14,35874048,575052914,20000,140000,884800,575937714
2018-09-17,35172578,566476063,0,80000,491200,566967263
2018-09-18,75116996,570642624,139700,140000,917000,571559624
2018-09-19,58219998,566993942,10000,130000,847600,567841542
2018-09-20,44978566,567922221,0,80000,520000,568442221
2018-09-21,47938118,561629112,70000,80000,534400,562163512
2018-09-25,44742883,577772318,0,80000,524000,578296318
2018-09-26,54146692,582041598,120000,130000,850200,582891798
2018-09-27,32862778,582622568,70000,80000,524800,583147368
2018-09-28,42764405,571310968,210000,220000,1425600,572736568
2018-10-08,39593086,575926157,0,210000,1320900,577247057
2018-10-09,27676901,567659912,0,210000,1325100,568985012
2018-10-10,40917577,569870201,92000,232000,1498720,571368921
2018-10-11,68023928,577406803,0,110000,664400,578071203
2018-10-12,56412474,569041276,101700,141700,878540,569919816
2018-10-15,27629534,558158418,10000,130000,795600,558954018
2018-10-16,40646456,542239928,0,110000,645700,542885628
2018-10-17,32740087,538039189,0,110000,658900,538698089
2018-10-18,40770309,536317061,100000,210000,1182300,537499361
2018-10-19,43086758,527877892,70000,150000,850500,528728392
2018-10-22,73441614,535990607,122000,162000,973620,536964227
2018-10-23,32930840,524548149,130000,220000,1295800,525843949
2018-10-24,28462735,520751767,0,150000,888000,521639767
2018-10-25,45333332,531568496,100000,250000,1475000,533043496
2018-10-26,60505288,515968218,60000,310000,1894100,517862318
2018-10-29,34287343,517452047,0,150000,895500,518347547
2018-10-30,64619437,535638572,50000,200000,1184000,536822572
2018-10-31,76318376,556938913,0,150000,901500,557840413
2018-11-01,69182276,543927728,100000,220000,1306800,545234528
2018-11-02,82280265,561397563,0,10000,60900,561458463
2018-11-05,80337706,585094366,110000,110000,656700,585751066
2018-11-06,59061032,585402950,170000,170000,992800,586395750
2018-11-07,72929805,613177751,0,0,0,613177751
2018-11-08,25789603,609615554,0,0,0,609615554
2018-11-09,27897490,601153683,0,0,0,601153683
2018-11-12,46547372,611259162,0,0,0,611259162
2018-11-13,53878346,602756582,0,0,0,602756582
2018-11-14,63871195,587865771,282000,282000,1627140,589492911
2018-11-15,43510569,578594884,0,100000,577000,579171884
2018-11-16,43882543,574182290,0,100000,571000,574753290
2018-11-19,63732375,578359435,0,100000,574000,578933435
2018-11-20,54943674,583738355,0,0,0,583738355
2018-11-21,46408398,584956229,221700,221700,1252605,586208834
2018-11-22,21832295,576565093,0,121000,675180,577240273
2018-11-23,25735134,549004791,20600,120600,635562,549640353
2018-11-26,33536897,543914951,0,110000,553300,544468251
2018-11-27,22117523,548032999,0,100000,504000,548536999
2018-11-28,34263964,559077743,0,100000,505000,559582743
2018-11-29,21656125,552235951,0,100000,490000,552725951
2018-11-30,20614446,553734952,0,100000,494000,554228952
2018-12-03,40428172,552676910,0,100000,508000,553184910
2018-12-04,53376454,556519506,231000,331000,1741060,558260566
2018-12-05,42854848,561884464,21000,161000,845250,562729714
2018-12-06,20408720,554121786,150000,250000,1280000,555401786
2018-12-07,13877634,545290753,0,100000,512000,545802753
2018-12-10,14373829,535898934,30000,130000,651300,536550234
2018-12-11,8278648,525327936,0,0,0,525327936
2018-12-12,12509853,517711518,135300,135300,692736,518404254
2018-12-13,46143613,536480494,21000,106300,553823,537034317
2018-12-14,27446786,526631944,0,106300,534689,527166633
2018-12-17,13945333,515585908,27000,112300,567115,516153023
2018-12-18,18886863,519460170,0,112300,561500,520021670
2018-12-19,11398269,514443215,92600,204900,1008108,515451323
2018-12-20,12555676,518570342,0,131300,649935,519220277
2018-12-21,9417133,519892147,0,131300,645996,520538143
2018-12-24,12732347,518187878,0,131300,640744,518828622
2018-12-25,22130464,511083642,50000,181300,841232,511924874
2018-12-26,11438739,511271190,0,91300,419067,511690257
2018-12-27,19777122,516310427,140000,231300,1057041,517367468
2018-12-28,10454797,508973786,0,91300,415415,509389201
2019-01-02,12552102,507335719,0,91300,408111,507743830
2019-01-03,11234713,502571032,0,91300,413589,502984621
2019-01-04,30166342,517254878,0,91300,424545,517679423
2019-01-07,25271877,516703931,0,85300,401763,517105694
2019-01-08,12854583,517203405,6000,51300,238545,517441950
2019-01-09,28937613,519670909,171000,222300,1040364,520711273
2019-01-10,16485466,519467811,0,51300,237006,519704817
2019-01-11,16558611,520390457,0,45300,211098,520601555
2019-01-14,44547542,520630650,250800,296100,1421280,522051930
2019-01-15,23692086,519323255,0,45300,217893,519541148
2019-01-16,16830096,518620799,162000,207300,992967,519613766
2019-01-17,50224933,536765141,97200,163500,791340,537556481
2019-01-18,92157693,546550538,303800,396300,2036982,548587520
2019-01-21,58036211,550643972,0,185300,946883,551590855
2019-01-22,53707723,568618927,0,185300,919088,569538015
2019-01-23,22893891,567428216,0,185300,913529,568341745
2019-01-24,19461171,561179845,0,85300,417970,561597815
2019-01-25,27662022,545466964,28000,113300,559702,546026666
2019-01-28,16009452,528771258,0,92300,453193,529224451
2019-01-29,59712204,534424198,398300,450600,2280036,536704234
2019-01-30,34832003,508643578,0,230300,1137682,509781260
2019-01-31,24372561,495314614,0,100300,487458,495802072
2019-02-01,21102071,474217589,26000,96300,477648,474695237
2019-02-11,45087176,489576503,0,76300,387604,489964107
2019-02-12,62882238,504936961,283000,359300,1850395,506787356
2019-02-13,94008639,535278260,63000,133300,701158,535979418
2019-02-14,60983965,538565448,0,70300,369778,538935226
2019-02-15,50129062,540088052,6000,76300,390656,540478708
2019-02-18,75059078,557873024,378000,448300,2384956,560257980
2019-02-19,99786751,538212809,0,45300,249150,538461959
2019-02-20,69107791,540312187,99700,145000,804750,541116937
2019-02-21,90782002,566928698,0,55000,298650,567227348
2019-02-22,67894087,587121989,314100,359400,1987482,589109471
2019-02-25,144068409,579952932,192900,247000,1432600,581385532
2019-02-26,155678921,562145285,324500,369800,2178122,564323407
2019-02-27,109391801,573016522,0,90300,523740,573540262
2019-02-28,70075839,601621804,165800,256100,1495624,603117428
2019-03-01,83397079,610591533,276200,345300,2057988,612649521
2019-03-04,126906859,616451553,247000,354300,2143515,618595068
2019-03-05,89704587,630323307,0,85300,511800,630835107
2019-03-06,161702923,657900124,507000,592300,3618953,661519077
2019-03-07,116617346,679462727,0,85300,517771,679980498
2019-03-08,85806609,690388632,102000,187300,1058245,691446877
2019-03-11,49474879,695110214,0,125300,724234,695834448
2019-03-12,74372786,693031469,100000,180000,1044000,694075469
2019-03-13,48853453,707416286,0,40000,226800,707643086
2019-03-14,42738580,694057373,80000,120000,688800,694746173
2019-03-15,52596850,692514002,0,80000,466400,692980402
2019-03-18,133773521,664654762,477000,497000,3071460,667726222
2019-03-19,84682578,642052745,0,150000,903000,642955745
2019-03-20,81083133,651477999,167000,227000,1366540,652844539
2019-03-21,57944907,651054124,0,85000,507450,651561574
2019-03-22,54053846,639066215,104800,189800,1129310,640195525
2019-03-25,41491418,610986973,0,25000,144000,611130973
2019-03-26,44516541,623583464,337000,362000,2048920,625632384
2019-03-27,29748525,626300047,70000,150000,858000,627158047
2019-03-28,32970539,617100807,0,20000,111800,617212607
2019-03-29,43943772,601873108,269700,289700,1654187,603527295
2019-04-01,110211590,611962450,20000,100000,591000,612553450
2019-04-02,70808006,620772338,140000,180000,1060200,621832538
2019-04-03,116521978,640548019,132000,212000,1267760,641815779
2019-04-04,119950912,650731446,165000,205000,1221800,651953246
2019-04-08,398634846,740778749,397900,422900,2774224,743552973
2019-04-09,261905313,753647860,140000,190000,1219800,754867660
2019-04-10,147098906,761565072,0,100000,623000,762188072
2019-04-11,90893179,765166675,600,90600,550848,765717523
2019-04-12,93792364,751288735,0,90600,533634,751822369
2019-04-15,103251819,765737780,35000,125600,724712,766462492
2019-04-16,77517277,774368775,64000,114600,673848,775042623
2019-04-17,60294398,775582104,10000,11100,64824,775646928
2019-04-18,62033007,776497988,25000,26100,153468,776651456
2019-04-19,55266841,766888101,220000,221100,1304490,768192591
2019-04-22,63120587,763235680,73400,184500,1053495,764289175
2019-04-23,46888527,763379114,0,141100,784516,764163630
2019-04-24,24425983,749502176,0,91100,513804,750015980
2019-04-25,33242997,744016459,0,51100,275429,744291888
2019-04-26,40167395,735886229,30000,31100,162031,736048260
2019-04-29,28008418,730367908,0,30000,152100,730520008
2019-04-30,13915641,717785410,95000,125000,646250,718431660
2019-05-06,22743417,696640060,130000,160000,764800,697404860
2019-05-07,25239568,698026469,78000,128000,613120,698639589
2019-05-08,23014426,692336052,58000,78000,369720,692705772
2019-05-09,11556027,692588872,0,78000,365040,692953912
2019-05-10,26189982,691492288,40000,80000,382400,691874688
2019-05-13,15932236,684109078,0,40000,186400,684295478
2019-05-14,10606395,680579771,41000,81000,373410,680953181
2019-05-15,12097867,678738427,90000,130000,612300,679350727
2019-05-16,29215103,672739027,181000,181000,876040,673615067
2019-05-17,21262442,669281488,0,141000,651420,669932908
2019-05-20,18246873,669175347,6700,121700,557386,669732733
2019-05-21,12245737,665854636,0,55000,260150,666114786
2019-05-22,19912506,671867269,209900,209900,986530,672853799
2019-05-23,14367287,671472464,35000,95000,437000,671909464
2019-05-24,7959434,670399951,45000,105000,479850,670879801
2019-05-27,14096648,671992804,0,60000,280200,672273004
2019-05-28,15606636,671234051,25000,85000,393550,671627601
2019-05-29,9020794,665740389,85000,90000,414900,666155289
2019-05-30,9826804,662090955,0,5000,22750,662113705
2019-05-31,5198681,655946196,60000,60000,271200,656217396
2019-06-03,10266011,650119955,25000,25000,111000,650230955
2019-06-04,11163466,645326748,14500,14500,62495,645389243
2019-06-05,6302330,640063491,0,14500,62495,640125986
2019-06-06,15318995,638660903,56500,61000,252540,638913443
2019-06-10,10862790,629927761,0,36000,148680,630076441
2019-06-11,27390161,629328214,290000,321500,1408170,630736384
2019-06-12,12381459,623903407,0,60000,259200,624162607
2019-06-13,9084715,617779965,0,60000,259200,618039165
2019-06-14,13380573,614836005,0,60000,253800,615089805
2019-06-17,8814278,612636464,60000,120000,508800,613145264
2019-06-18,3341393,611433822,0,120000,507600,611941422
2019-06-19,14409748,608256919,0,60000,259800,608516719
2019-06-20,25908864,612263272,50000,90000,394200,612657472
2019-06-21,17807435,609244753,0,40000,176800,609421553
2019-06-24,36253920,607973614,511000,551000,2523580,610497194
2019-06-25,16996192,596245867,0,40000,179200,596425067
2019-06-26,7701696,596027725,0,40000,180000,596207725
2019-06-27,16139280,593878478,216700,256700,1162851,595041329
2019-06-28,13051117,594603717,0,47600,210868,594814585
2019-07-01,14677359,589434832,0,40000,181600,589616432
2019-07-02,9131837,579097246,100000,140000,638400,579735646
2019-07-03,18062513,585905256,113500,153500,690750,586596006
2019-07-04,9366416,584728583,0,40000,178400,584906983
2019-07-05,4948769,583465941,0,40000,180400,583646341
2019-07-08,22548621,590019425,36300,76300,330379,590349804
2019-07-09,9954168,583511629,0,51300,220590,583732219
2019-07-10,10112646,584101867,0,40000,168000,584269867
2019-07-11,6658908,584194147,24000,64000,266880,584461027
2019-07-12,8496237,586310140,0,64000,267520,586577660
2019-07-15,6497827,580925154,7300,71300,302312,581227466
2019-07-16,18223542,586078304,269600,340900,1479506,587557810
2019-07-17,9577932,584018684,0,226300,973090,584991774
2019-07-18,6060422,582221622,0,126300,531723,582753345
2019-07-19,10116291,586009395,0,71300,301599,586310994
2019-07-22,9846024,580832078,0,71300,293756,581125834
2019-07-23,7416027,582380486,0,71300,296608,582677094
2019-07-24,13246662,586135387,0,71300,298747,586434134
2019-07-25,7328709,583817328,90000,161300,674234,584491562
2019-07-26,6682935,585132209,0,71300,297321,585429530
2019-07-29,7066202,585097904,0,31300,129269,585227173
2019-07-30,8026045,584578755,0,31300,129895,584708650
2019-07-31,8974478,587768334,0,31300,128330,587896664
2019-08-01,7903581,587827128,0,31300,127704,587954832
2019-08-02,11034639,583319555,0,31300,123948,583443503
2019-08-05,4779408,579737092,0,31300,121131,579858223
2019-08-06,16503558,579716923,0,0,0,579716923
2019-08-07,6490601,579078821,0,0,0,579078821
2019-08-08,3470689,571883355,31300,31300,117375,572000730
2019-08-09,1080403,563933892,100000,131300,491062,564424954
2019-08-12,5576398,565175184,0,31300,118001,565293185
2019-08-13,3588765,563603385,0,31300,116436,563719821
2019-08-14,4195935,561533881,0,31300,117375,561651256
2019-08-15,10903107,559247734,60000,60000,226200,559473934
2019-08-16,7737928,555912043,0,0,0,555912043
2019-08-19,9064441,554195514,0,0,0,554195514
2019-08-20,9902551,549898908,0,0,0,549898908
2019-08-21,5612407,550594556,0,0,0,550594556
2019-08-22,4559127,546688888,0,0,0,546688888
2019-08-23,2836140,541483697,0,0,0,541483697
2019-08-26,5606740,540416540,0,0,0,540416540
2019-08-27,5042641,539006255,0,0,0,539006255
2019-08-28,6680892,535680463,0,0,0,535680463
2019-08-29,8287952,536177425,0,0,0,536177425
2019-08-30,9416716,536959565,0,0,0,536959565
2019-09-02,4560967,528663384,0,0,0,528663384
2019-09-03,7049570,526295822,0,0,0,526295822
2019-09-04,8200046,520878185,80000,80000,320000,521198185
2019-09-05,8577418,514452359,0,0,0,514452359
2019-09-06,3857666,513809528,0,0,0,513809528
2019-09-09,7307627,509077714,0,0,0,509077714
2019-09-10,13637327,509777908,12000,12000,48600,509826508
2019-09-11,3510139,503215439,0,12000,48360,503263799
2019-09-12,6426169,494325980,41700,53700,219633,494545613
2019-09-16,7913654,493642031,40000,52000,212160,493854191
2019-09-17,10981073,497013664,0,12000,47760,497061424
2019-09-18,4527366,494852195,0,12000,47520,494899715
2019-09-19,8736851,496406842,0,12000,47640,496454482
2019-09-20,4007291,495774123,0,12000,47280,495821403
2019-09-23,11909869,502219175,19300,31300,121131,502340306
2019-09-24,5642196,488807545,0,19300,73919,488881464
2019-09-25,5076586,482107087,0,0,0,482107087
2019-09-26,8071890,486049428,0,0,0,486049428
2019-09-27,2451035,481378971,0,0,0,481378971
2019-09-30,5122332,477375329,0,0,0,477375329
2019-10-08,7576780,474440013,0,0,0,474440013
2019-10-09,3012798,473145177,0,0,0,473145177
2019-10-10,8543784,474908183,0,0,0,474908183
2019-10-11,3411199,470513144,0,0,0,470513144
2019-10-14,16441740,474591700,5100,5100,19635,474611335
2019-10-15,3668566,473604391,11200,16300,61614,473666005
2019-10-16,4339980,470191559,0,6000,22440,470213999
2019-10-17,3052116,464226141,3000,9000,33750,464259891
2019-10-18,4144440,459695045,0,8900,32752,459727797
2019-10-21,4125992,459653512,20600,29500,108265,459761777
2019-10-22,3438098,457322795,0,29500,108855,457431650
2019-10-23,2374890,455833206,0,20500,75030,455908236
2019-10-24,1585123,451855918,0,20500,75030,451930948
2019-10-25,2389684,449555490,0,20500,75440,449630930
2019-10-28,4067733,447582149,0,0,0,447582149
2019-10-29,5859464,444986768,0,0,0,444986768
2019-10-30,5640319,440055947,0,0,0,440055947
2019-10-31,4111213,437141954,1500,1500,5175,437147129
2019-11-01,4194018,436958086,0,1500,5265,436963351
2019-11-04,2054918,435354512,0,1500,5235,435359747
2019-11-05,5250177,435554912,40000,41500,144835,435699747
2019-11-06,20558471,439655416,70500,72000,260640,439916056
2019-11-07,11401060,440118347,900,2400,8568,440126915
2019-11-08,17936904,447712703,40000,42400,148824,447861527
2019-11-11,7413727,449432741,1900,4300,14835,449447576
2019-11-12,3146554,449344573,6100,10400,36088,449380661
2019-11-13,4427207,448085293,0,10400,35880,448121173
2019-11-14,2173043,448555688,0,4300,14921,448570609
2019-11-15,12670715,449037893,118200,122500,431200,449469093
2019-11-18,36687618,448227756,0,5000,18750,448246506
2019-11-19,32329221,444538054,59800,64800,250776,444788830
2019-11-20,32838790,451586211,90000,114800,451164,452037375
2019-11-21,10418923,436187115,104000,218800,859884,437046999
2019-11-22,71018308,430896745,37700,171700,729725,431626470
2019-11-25,42934668,425101749,121000,292700,1369836,426471585
2019-11-26,101177024,450189776,60000,339400,1561240,451751016
2019-11-27,108296266,462336277,11800,281200,1338512,463674789
2019-11-28,84706021,471252647,264000,499700,2218668,473471315
2019-11-29,73839882,456970517,808200,1216600,5462534,462433051
2019-12-02,54354866,444944231,185000,1273400,5793970,450738201
2019-12-03,63501876,455510397,392000,1309700,5841262,461351659
2019-12-04,57725103,442610316,645200,1204700,5288633,447898949
2019-12-05,51994073,450435698,485600,1440100,6408445,456844143
2019-12-06,27445470,446354820,94500,1229000,5444470,451799290
2019-12-09,120009881,468241354,1283905,2059305,9740513,477981867
2019-12-10,54989230,434744400,150700,1673600,7732032,442476432
2019-12-11,88633440,443124733,1267300,2568300,12327840,455452573
2019-12-12,47960892,438363976,138600,1951900,9349601,447713577
2019-12-13,41458284,430400529,326800,1525600,7277112,437677641
2019-12-16,58484275,439113160,200000,1521300,7287027,446400187
2019-12-17,115355601,471099811,603500,1642200,8128890,479228701
2019-12-18,62421766,461271434,244000,1496300,7182240,468453674
2019-12-19,47052937,469133929,232500,1272600,6057576,475191505
2019-12-20,44115658,476540740,477300,1343100,6218553,482759293
2019-12-23,40934948,486315622,386400,1533700,6840302,493155924
2019-12-24,23827119,462995963,100900,1130700,5110764,468106727
2019-12-25,23276696,454355276,101400,1136900,5081943,459437219
2019-12-26,42877716,463062685,1140363,2187263,10039537,473102222
2019-12-27,48669485,468395682,322400,1400600,6498784,474894466
2019-12-30,44780810,475654807,326000,1216300,5692284,481347091
2019-12-31,60808034,463054711,910316,1816616,8610760,471665471
2020-01-02,64411285,468155663,133000,1234200,5899476,474055139
2020-01-03,35976077,466438060,151500,1203100,5618477,472056537
2020-01-06,27491073,467342694,95500,992600,4575886,471918580
2020-01-07,81564344,442629301,2059300,2856400,14481948,457111249
2020-01-08,75264987,450308754,299082,1885982,9335611,459644365
2020-01-09,63216478,461248303,140000,1722682,8423915,469672218
2020-01-10,55679992,483945670,165000,1702682,8036659,491982329
2020-01-13,34325459,488280975,60000,1059582,4990631,493271606
2020-01-14,44395925,497371529,515800,1514282,7192840,504564369
2020-01-15,28011114,499300590,0,1009982,4716616,504017206
2020-01-16,18186293,499852828,84000,925882,4305351,504158179
2020-01-17,16729565,497268348,48500,855182,3942389,501210737
2020-01-20,24343803,490833182,52500,764182,3561088,494394270
2020-01-21,22004265,485241126,0,594000,2661120,487902246
2020-01-22,23054264,478650150,100000,694000,3123000,481773150
2020-01-23,18426882,465334238,0,311100,1306620,466640858
2020-02-03,926856,451874815,0,249100,941598,452816413
2020-02-04,22123306,445011353,0,220600,811808,445823161
2020-02-05,12794484,436235019,0,220600,831662,437066681
2020-02-06,16117887,430987310,0,220600,842692,431830002
2020-02-07,15433636,432012609,3500,224100,851580,432864189
2020-02-10,36911333,435240736,320200,536800,2163304,437404040
2020-02-11,53181422,449744969,302200,529300,2186009,451930978
2020-02-12,32683968,439851269,123400,398700,1638657,441489926
2020-02-13,26035763,440981941,1300,357000,1449420,442431361
2020-02-14,35245887,445332209,415500,740000,3041400,448373609
2020-02-17,52852200,459684677,9300,445300,1861354,461546031
2020-02-18,31967138,445526574,114600,552500,2303925,447830499
2020-02-19,23747451,446617848,71900,524400,2202480,448820328
2020-02-20,41916942,456844951,227500,616900,2627994,459472945
2020-02-21,60995873,464037325,315100,707700,3078495,467115820
2020-02-24,52142048,473898208,225200,662700,2862864,476761072
2020-02-25,38412750,475910171,900,354800,1486612,477396783
2020-02-26,65815617,471850844,946900,1261700,5437927,477288771
2020-02-27,55147367,482638049,34600,627300,2634660,485272709
2020-02-28,37483276,469561287,361978,771278,3023410,472584697
2020-03-02,83623444,492674034,584000,930500,3991845,496665879
2020-03-03,54250532,486423710,344900,897900,3905865,490329575
2020-03-04,111556069,520021012,725600,1292600,5816700,525837712
2020-03-05,75160951,500379090,296100,937100,4254434,504633524
2020-03-06,57424926,494489280,190400,848200,3706634,498195914
2020-03-09,32564254,471065926,39700,812900,3349148,474415074
2020-03-10,39475576,466660721,374900,1187800,4953126,471613847
2020-03-11,42380298,471313100,301600,1156900,4743290,476056390
2020-03-12,23607921,466798352,53400,915300,3688659,470487011
2020-03-13,16835900,463245896,0,815300,3228588,466474484
2020-03-16,18748077,457531355,22600,807200,3107720,460639075
2020-03-17,10211737,454302451,70000,857200,3283076,457585527
2020-03-18,12279926,448458500,7700,807300,3035448,451493948
2020-03-19,12418223,445112449,44400,778000,2917500,448029949
2020-03-20,13380045,441575500,94600,848100,3214299,444789799
2020-03-23,7531988,439865149,85200,684700,2506002,442371151
2020-03-24,14530323,439400460,76000,575300,2145869,441546329
2020-03-25,14306540,438216929,15000,494300,1873397,440090326
2020-03-26,8005326,432040240,35300,512000,1904640,433944880
2020-03-27,14935393,429207484,331883,808883,3073755,432281239
2020-03-30,13640397,428176509,392000,1070900,4101547,432278056
2020-03-31,17183085,433078885,56400,862300,3319855,436398740
2020-04-01,11083940,435662021,305346,1138646,4292695,439954716
2020-04-02,6124071,429233581,22100,831800,3169158,432402739
2020-04-03,6629182,418463478,66900,594500,2205595,420669073
2020-04-07,15387848,419785670,402500,965200,3667760,423453430
2020-04-08,12354895,419402178,171000,918500,3563780,422965958
2020-04-09,16678981,421690905,58955,700855,2712309,424403214
2020-04-10,5854340,419115379,225800,915855,3480249,422595628
2020-04-13,11780430,416450174,34800,749555,2885787,419335961
2020-04-14,13882178,423703242,23300,772455,2989401,426692643
2020-04-15,9909341,420721752,25200,783455,2992798,423714550
2020-04-16,6124900,411417339,20300,716155,2707066,414124405
2020-04-17,13086398,411797922,181700,706655,2692356,414490278
2020-04-20,29906451,425691944,182100,758555,2935608,428627552
2020-04-21,11576039,417633903,77600,687155,2604317,420238220
2020-04-22,9551342,416541428,130400,817555,3090358,419631786
2020-04-23,6710828,405559772,14700,802755,3010331,408570103
2020-04-24,6098605,401938687,40600,825955,3072553,405011240
2020-04-27,4882371,400857482,32500,756255,2798144,403655626
2020-04-28,7174310,387915677,216200,885055,3177347,391093024
2020-04-29,11214163,393294889,122100,976855,3575289,396870178
2020-04-30,11937598,392362774,25700,982755,3685331,396048105
2020-05-06,15926094,393787626,41600,988755,3777044,397564670
2020-05-07,29321182,400846513,4300,947555,3667038,404513551
2020-05-08,13741067,407304710,300,946555,3663168,410967878
2020-05-11,24098184,420631843,309300,1252855,4911192,425543035
2020-05-12,25037029,430896512,18800,1092555,4260965,435157477
2020-05-13,3570436,421290805,57100,1117355,4346511,425637316
2020-05-14,12917093,426351347,110400,1225955,4695408,431046755
2020-05-15,10405018,431395969,89300,1247755,4778902,436174871
2020-05-18,6204660,429878915,25300,1230055,4735712,434614627
2020-05-19,7674171,421057939,167600,1291255,4984244,426042183
2020-05-20,5324425,419851367,42800,1238455,4730898,424582265
2020-05-21,23582555,428074964,154100,1376055,5407896,433482860
2020-05-22,11372671,430580929,91100,1379355,5393278,435974207
2020-05-25,11976011,438083428,50000,1398755,5413182,443496610
2020-05-26,18414880,443377918,5800,1200355,4681384,448059302
2020-05-27,11038664,433100042,140500,1336700,4972524,438072566
2020-05-28,7870179,427037168,299500,1588900,5847152,432884320
2020-05-29,5933246,426584144,4400,1562500,5750000,432334144
2020-06-01,14709577,429711689,5000,1525600,5766768,435478457
2020-06-02,9138580,423044767,106000,1591900,6128815,429173582
2020-06-03,10768412,423655655,38900,1615800,6236988,429892643
2020-06-04,12968956,426278207,200,1616000,6156960,432435167
2020-06-05,4205308,421172658,0,1614400,6070144,427242802
2020-06-08,7296674,417035498,113600,1722500,6579950,423615448
2020-06-09,10705616,416479432,3900,1582300,5981094,422460526
2020-06-10,7981669,410101014,140500,1616800,6176176,416277190
2020-06-11,14854358,413360016,55100,1561700,5856375,419216391
2020-06-12,13677912,406543582,44000,1600600,6130298,412673880
2020-06-15,12805784,399533154,4800,1519000,5741820,405274974
2020-06-16,43592700,402929618,131400,1648100,6542957,409472575
2020-06-17,56619318,428534118,49100,1503950,6090998,434625116
2020-06-18,52001915,427802528,273300,1569850,6404988,434207516
2020-06-19,38190479,413244437,65100,1380950,5482372,418726809
2020-06-22,19723460,406215588,71100,1295050,5076596,411292184
2020-06-23,18697482,400054505,349300,1561250,6042038,406096543
2020-06-24,14811405,390902965,86300,1368050,5253312,396156277
2020-06-29,13990529,382075221,23200,1334750,5058703,387133924
2020-06-30,11524088,379387804,128400,1418450,5390110,384777914
2020-07-01,19184669,379688715,308100,1723250,6686210,386374925
2020-07-02,31221542,383409932,259900,1806350,7189273,390599205
2020-07-03,46814266,389099087,293800,1822750,7491503,396590590
2020-07-06,94003098,424528909,151800,1660750,7506590,432035499
2020-07-07,105323437,424072769,255100,1711850,7771799,431844568
2020-07-08,173960007,450345693,230400,1680950,8219846,458565539
2020-07-09,113693420,424784404,480822,1925272,9587855,434372259
2020-07-10,101895765,458937024,173000,1956150,9115659,468052683
2020-07-13,93808891,481581453,424635,2251385,11054301,492635754
2020-07-14,64756137,485982588,193300,2063185,9944552,495927140
2020-07-15,48580773,467068555,464100,2264985,10486881,477555436
2020-07-16,32867244,462765801,263800,2090785,9199454,471965255
2020-07-17,27048118,461204554,194200,2026685,8937681,470142235
2020-07-20,67040771,473498543,378100,2188050,10502640,484001183
2020-07-21,26836035,471150994,296671,2147821,10094759,481245753
2020-07-22,43774895,484384344,322600,2373821,11109482,495493826
2020-07-23,27164279,479550164,93900,2438921,11267815,490817979
2020-07-24,33957232,476482385,154000,2455821,10781055,487263440
2020-07-27,22672713,467504082,129900,2466521,10828028,478332110
2020-07-28,21279585,464487948,306500,2661121,11788767,476276715
2020-07-29,18460543,454311490,136000,2455521,11025290,465336780
2020-07-30,22643087,458856645,122200,2436021,10815933,469672578
2020-07-31,22720742,458993388,35800,2185450,9681544,468674932
2020-08-03,48976668,471181718,404500,2452750,11331705,482513423
2020-08-04,36039993,478847313,148800,2379150,10920299,489767612
2020-08-05,15743798,465723541,83900,2258950,10255633,475979174
2020-08-06,30339766,466854345,576274,2826524,13058541,479912886
2020-08-07,25712528,459877140,276128,2704046,12060045,471937185
2020-08-10,24849476,464897460,203500,2825746,12744115,477641575
2020-08-11,25628143,464741716,26100,2698946,11821383,476563099
2020-08-12,14600732,465931139,167999,2778345,12030235,477961374
2020-08-13,8344286,456096972,440400,3110245,13653976,469750948
2020-08-14,16551160,460138858,49500,2678745,11813266,471952124
2020-08-17,21765582,458067251,99900,2686845,12171408,470238659
2020-08-18,39569036,464666641,385600,2958645,13698526,478365167
2020-08-19,22664001,461105023,194700,2899645,13106395,474211418
2020-08-20,16860400,462081587,298300,2988045,13296801,475378388
2020-08-21,20045717,447828884,100500,2788845,12382472,460211356
2020-08-24,14962511,445234561,148000,2728945,12007358,457241919
2020-08-25,7617547,438901067,80300,2732345,11913025,450814092
2020-08-26,10480757,436379310,57600,2774845,11876337,448255647
2020-08-27,12724449,440078023,235000,2928645,12739607,452817630
2020-08-28,29748010,445553304,160100,2792645,12455197,458008501
2020-08-31,17738672,444503001,69400,2609445,11429369,455932370
2020-09-01,6205267,435832527,34900,2541545,11157383,446989910
2020-09-02,16261028,438281262,304500,2846045,12551059,450832321
2020-09-03,16792175,433571061,249000,2935145,12973341,446544402
2020-09-04,13970910,426230085,17900,2840545,12271155,438501240
2020-09-07,6055874,419484218,48700,2852745,12181222,431665440
2020-09-08,10801293,418552906,283300,3013445,13168756,431721662
2020-09-09,31280758,425637399,132700,2961145,13265930,438903329
2020-09-10,20881001,429865010,71900,2816845,12253277,442118287
2020-09-11,10131460,425278692,44700,2764945,11778666,437057358
2020-09-14,13454592,430895138,59800,2824745,11980189,442875327
2020-09-15,6913467,430392013,152900,2952645,12489689,442881702
2020-09-16,7095057,428520951,39400,2943245,12361629,440882580
2020-09-17,4315914,423930487,26700,2782645,11687109,435617596
2020-09-18,19009829,429348477,57100,2839745,12267699,441616176
2020-09-21,11596171,423790230,339897,3101942,13462429,437252659
2020-09-22,3251863,414719420,107200,3160545,13590344,428309764
2020-09-23,4851089,415531811,28300,2942545,12564668,428096479
2020-09-24,2938289,412138831,158204,3073249,12938379,425077210
2020-09-25,1283705,400745183,35300,3072945,12937099,413682282
2020-09-28,912498,398220827,2500,3042645,12839962,411060789
2020-09-29,5229046,399664020,10100,2930045,12364790,412028810
2020-09-30,3930399,397539094,170900,3020345,12534432,410073526
2020-10-09,2996140,396402351,100,2888245,12217277,408619628
2020-10-12,12684945,402142034,24600,2897945,12548103,414690137
2020-10-13,5455228,402071179,60800,2892445,12408590,414479769
2020-10-14,4427464,401544545,91000,2954845,12528543,414073088
2020-10-15,8819020,402462269,64700,3016645,12850908,415313177
2020-10-16,16635931,405269017,64700,3056145,13324793,418593810
2020-10-19,15563735,402891326,49500,3078445,13268099,416159425
2020-10-20,5017983,398011174,41400,3119745,13383707,411394881
2020-10-21,3709639,388406910,30600,3119945,13290966,401697876
2020-10-22,6305670,380502195,8200,3115245,13395554,393897749
2020-10-23,5378573,381109448,23600,3108345,13210467,394319915
2020-10-26,3182583,381772651,34900,3037945,12880887,394653538
2020-10-27,3941725,381319388,1500,2987945,12609128,393928516
2020-10-28,8108544,380603457,235500,3223045,13859094,394462551
2020-10-29,4034939,380548476,32300,3240045,13996995,394545471
2020-10-30,6659086,379034245,27900,3153545,13244889,392279134
2020-11-02,4331475,379455733,3200,3104245,13037829,392493562
2020-11-03,10376080,378703518,2800,3103845,13315496,392019014
2020-11-04,9045013,375324309,5200,3101945,13462442,388786751
2020-11-05,30180295,387810227,105000,3166645,14028238,401838465
2020-11-06,14278277,388976685,3900,3009245,13330956,402307641
2020-11-09,36139656,400519075,60031,2982476,13450967,413970042
2020-11-10,16568770,393809799,126300,3045976,13524134,407333933
2020-11-11,109778812,441385894,163000,3124276,15246466,456632360
2020-11-12,54511021,417390929,152448,3070508,14830555,432221484
2020-11-13,61030720,410758494,174300,3174408,14983205,425741699
2020-11-16,74825883,426130370,53800,3153208,15419188,441549558
2020-11-17,70218932,440452091,274300,3341208,16371919,456824010
2020-11-18,39322499,425655208,72800,3054808,14815819,440471027
2020-11-19,36958140,426005104,56100,2975309,14311237,440316341
2020-11-20,44495618,425217786,182400,2888109,14093971,439311757
2020-11-23,70251231,411639665,165300,2840209,13888623,425528288
2020-11-24,47930452,420983361,80900,2631161,13076870,434060231
2020-11-25,46535213,415142404,58500,2491861,11761583,426903987
2020-11-26,16649678,408000909,159383,2537044,12000219,420001128
2020-11-27,65177530,415544804,300307,2646051,13018571,428563375
2020-11-30,53190636,428216567,134200,2383051,11438645,439655212
2020-12-01,28070213,409865192,2000,2116401,10349201,420214393
2020-12-02,49749841,411867169,355300,2180001,10856404,422723573
2020-12-03,40289155,418914343,11100,1450727,6977997,425892340
2020-12-04,30504315,417811871,87000,1283896,6201218,424013089
2020-12-07,22664680,421159453,8100,1051596,4963533,426122986
2020-12-08,15459908,412718292,20700,907196,4173102,416891394
2020-12-09,15489195,413622819,238100,971196,4438366,418061185
2020-12-10,33109034,410569665,205000,994796,4695437,415265102
2020-12-11,18696962,401566136,62400,984496,4528682,406094818
2020-12-14,19730256,401399565,8700,866496,3795252,405194817
2020-12-15,8256416,401151498,245500,1083696,4779099,405930597
2020-12-16,13754876,402332666,38100,826796,3588295,405920961
2020-12-17,11468596,390029007,179500,996696,4435297,394464304
2020-12-18,17568206,382927969,404800,1334196,6123960,389051929
2020-12-21,24047512,391104312,133000,1103496,5109186,396213498
2020-12-22,23144058,387077986,257700,1276296,5564651,392642637
2020-12-23,14712604,390375428,167000,1443196,6292335,396667763
2020-12-24,14173385,390627180,140900,1524096,6431685,397058865
2020-12-25,10377547,382529085,563700,2087796,9144546,391673631
2020-12-28,12315061,386937030,246300,1954596,8404763,395341793
2020-12-29,12744746,389691018,323900,2278496,9615253,399306271
2020-12-30,9528280,388703324,84000,2177696,9255208,397958532
2020-12-31,17119158,389594190,139500,2308396,9856851,399451041
2021-01-04,18785927,394286981,544100,2829596,12195559,406482540
2021-01-05,21609327,400858854,119000,2580196,10914229,411773083
2021-01-06,10524574,394947084,89000,2668996,11209783,406156867
2021-01-07,18486229,388465555,370800,3039796,12858337,401323892
2021-01-08,18707936,387238037,17500,2593496,10866748,398104785
2021-01-11,14886592,387674351,27000,2458096,9955289,397629640
2021-01-12,8677740,387550013,66300,2184696,8979101,396529114
2021-01-13,7890704,384328831,10600,1848396,7504488,391833319
2021-01-14,14177205,388364762,273700,2115596,8716256,397081018
2021-01-15,5734683,381149064,66100,1949996,7955984,389105048
2021-01-18,10371511,383284882,135700,2050696,8387347,391672229
2021-01-19,7295543,384359373,55400,2103396,8602890,392962263
2021-01-20,13240788,381382881,189500,2285196,9529267,390912148
2021-01-21,27600553,399101512,35800,2198396,9101359,408202871
2021-01-22,7010089,397233503,13000,2114196,8583636,405817139
2021-01-25,10902170,400341761,800,2086096,8469550,408811311
2021-01-26,2657004,391025234,258000,2300896,9272611,400297845
2021-01-27,2903999,385394994,49600,2350496,9472499,394867493
2021-01-28,6472835,381329445,63000,2411096,9716717,391046162
2021-01-29,2553894,378880816,22700,2416196,9616460,388497276
2021-02-01,4938781,374616182,35300,2450296,9752178,384368360
2021-02-02,3182983,367821806,71000,2520596,10208414,378030220
2021-02-03,6589712,364455283,8100,2519496,10254349,374709632
2021-02-04,3304970,362721274,62100,2569596,10483952,373205226
2021-02-05,6125287,362698906,60000,2618296,10682648,373381554
2021-02-08,7662262,364184346,5100,2623296,10676815,374861161
2021-02-09,4676945,360210650,3200,2626496,10768634,370979284
2021-02-10,7550125,356902456,35100,2554396,10370848,367273304
2021-02-18,18210231,361385522,48100,2535296,10724302,372109824
2021-02-19,22475380,370966794,89000,2538596,10966735,381933529
2021-02-22,57191018,385157717,23700,2391496,10976967,396134684
2021-02-23,54790780,405583252,105800,2387496,10743732,416326984
2021-02-24,17222841,403558450,61800,2308696,10227523,413785973
2021-02-25,47866713,406627903,215100,2471796,11123082,417750985
2021-02-26,15233190,394672825,37100,2508396,10911523,405584348
2021-03-01,11986774,388339672,119500,2423896,10931771,399271443
2021-03-02,24948573,396828880,37400,2450696,10832076,407660956
2021-03-03,79978789,403703643,141400,2465396,11784593,415488236
2021-03-04,72778263,413120879,184700,2561396,12422771,425543650
2021-03-05,72219251,446893037,83500,2474896,11310275,458203312
2021-03-08,44692772,463904871,124300,2538796,11627686,475532557
2021-03-09,59468110,477290949,42200,2431996,11430381,488721330
2021-03-10,73691045,517903095,147600,2444496,11538021,529441116
2021-03-11,75170637,553285424,310500,2562696,12864734,566150158
2021-03-12,93752233,461788899,168200,2713496,13296130,475085029
2021-03-15,74625229,475259066,92400,2721496,13634695,488893761
2021-03-16,39205486,453936292,82300,2764896,13547990,467484282
2021-03-17,102567260,509506919,12300,2745685,13426399,522933318
2021-03-18,82619165,545998931,31900,2777485,13498578,559497509
2021-03-19,27012942,541456220,21900,2766985,13336868,554793088
2021-03-22,103393267,614423667,400,2284985,11264976,625688643
2021-03-23,66562474,634050388,6700,2220785,10548729,644599117
2021-03-24,33085763,637605337,7100,2214189,10229553,647834890
2021-03-25,7927434,635413138,0,2103289,9696162,645109300
2021-03-26,24131311,633453160,97500,2184389,10244784,643697944
2021-03-29,19752898,627825081,732400,2916789,13825580,641650661
2021-03-30,46485130,563353315,104900,3000789,14523819,577877134
2021-03-31,51847599,594185639,68300,2987289,14548097,608733736
2021-04-01,86772131,586657961,90500,2851989,14545144,601203105
2021-04-02,31932024,542096693,220900,3058689,15293445,557390138
2021-04-06,35023847,550390605,197400,3250789,16383977,566774582
2021-04-07,43470412,544997578,43100,3180989,16827432,561825010
2021-04-08,155288152,497660829,151400,3218389,17057462,514718291
2021-04-09,73630400,500396647,107200,2921389,15863142,516259789
2021-04-12,85492606,510798208,329800,3234489,17951414,528749622
2021-04-13,58776808,517581892,21300,2958889,16007589,533589481
2021-04-14,47541724,513042241,169200,3109289,16976718,530018959
2021-04-15,27649446,496865389,263400,3304789,17647573,514512962
2021-04-16,28180200,490546375,76100,3345989,17834121,508380496
2021-04-19,39422554,503760560,0,3082589,16214418,519974978
2021-04-20,28999930,508303061,67900,3002789,15674559,523977620
2021-04-21,30179391,497763045,13800,2949489,15248858,513011903
2021-04-22,33921567,495259955,67800,2954089,15597590,510857545
2021-04-23,64403191,520801288,1300,2933189,15809889,536611177
2021-04-26,74839276,554229619,29200,2911889,15316536,569546155
2021-04-27,23322891,556568012,73700,2970789,15715474,572283486
2021-04-28,60328001,559453729,513100,3213889,17612112,577065841
2021-04-29,69907844,533723077,177200,3249189,16700831,550423908
2021-04-30,26623775,505840522,41200,2920089,14571244,520411766
2021-05-06,55169197,499364986,67548,2704437,14847360,514212346
2021-05-07,68202390,497673412,143800,2787289,15330090,513003502
2021-05-10,64305988,515501260,152500,2831489,16281062,531782322
2021-05-11,41968530,516229714,343700,3094489,17174414,533404128
2021-05-12,62284061,541261279,229800,3279489,18496318,559757597
2021-05-13,53900997,548617682,140800,3303389,17970436,566588118
2021-05-14,51705473,552694502,134100,3331289,17889022,570583524
2021-05-17,34569024,563869583,83652,3284141,17438789,581308372
2021-05-18,27815119,564952784,89200,3281241,17456202,582408986
2021-05-19,31827509,564148034,57300,3202389,16524327,580672361
2021-05-20,26682859,545793614,56700,3170589,15535886,561329500
2021-05-21,9095034,538597453,173200,3288889,16247112,554844565
2021-05-24,8021146,537144274,178700,3227389,15781932,552926206
2021-05-25,13579577,531243902,54000,3206089,15838080,547081982
2021-05-26,7783602,529990560,22000,2949089,14568500,544559060
2021-05-27,12382394,528508699,16000,2904389,14463857,542972556
2021-05-28,11110789,507494810,54700,2924389,14592701,522087511
2021-05-31,10232153,502191128,58600,2920889,14516818,516707946
2021-06-01,51235004,534143436,156400,2971289,14915871,549059307
2021-06-02,13125468,532087761,46100,2412389,12182564,544270325
2021-06-03,21775490,523796866,173000,2379689,12136414,535933280
2021-06-04,23982203,502223383,75600,2042589,10723592,512946975
2021-06-07,96995372,562032553,85500,1837389,9756536,571789089
2021-06-08,112959040,645224239,176800,1696189,8989802,654214041
2021-06-09,47867088,598328395,39800,1190300,6070530,604398925
2021-06-10,22705451,566557926,53300,1046700,5411439,571969365
2021-06-11,53476967,591230679,140100,1114300,5861218,597091897
2021-06-15,19805968,588348689,88100,1162700,5987905,594336594
2021-06-16,8812446,497261304,244300,1243800,6293628,503554932
2021-06-17,44460650,529770803,164900,1362200,6906354,536677157
2021-06-18,41683041,552515630,108500,1413100,7220941,559736571
2021-06-21,21612020,560004516,220100,1594400,8067664,568072180
2021-06-22,20756666,485234964,272000,1807400,8621298,493856262
2021-06-23,15082274,478101205,139600,1825000,8614000,486715205
2021-06-24,16403461,468561625,282800,2034900,9360540,477922165
2021-06-25,25570909,476443445,125700,2132300,10085779,486529224
2021-06-28,23121644,484875274,165600,2269800,10441080,495316354
2021-06-29,10963787,488987957,162100,2394100,10917096,499905053
2021-06-30,7572497,490749175,112400,2506500,11504835,502254010
2021-07-01,14168180,493843594,72300,2563600,11613108,505456702
2021-07-02,15488366,493425573,16800,2478200,10928862,504354435
2021-07-05,11137124,490628402,28700,2288600,10092726,500721128
2021-07-06,14934323,491855373,32800,2300500,10168210,502023583
2021-07-07,13363949,479642294,128100,2383600,10678528,490320822
2021-07-08,14283106,477753118,96200,2462300,10784874,488537992
2021-07-09,33661948,493888076,37700,2455900,11198904,505086980
2021-07-12,24322395,500844545,79900,2534500,11582665,512427210
2021-07-13,12298389,500678519,214500,2730600,12588066,513266585
2021-07-14,9813568,502014031,31200,2677400,12262492,514276523
2021-07-15,48197966,519577294,19200,2638900,12429219,532006513
2021-07-16,29931845,510993302,111600,2690700,12700104,523693406
2021-07-19,13573873,512153604,37400,2550600,11860290,524013894
2021-07-20,13710893,506806217,27000,2534600,11709852,518516069
2021-07-21,17337806,502350417,6500,2505200,11523920,513874337
2021-07-22,33016800,500873991,14300,2464500,11780310,512654301
2021-07-23,44335662,502518240,21900,2423800,11634240,514152480
2021-07-26,17557876,509557702,600,2417100,11432883,520990585
2021-07-27,26501400,506212099,24700,2427900,10974108,517186207
2021-07-28,18621746,508992992,43100,2451900,10910955,519903947
2021-07-29,15909736,514300990,41400,2493300,11219850,525520840
2021-07-30,22113720,506547506,26800,2462000,11792980,518340486
2021-08-02,27548799,520917493,91300,2553300,11566449,532483942
2021-08-03,26916853,531900962,185500,2738800,11913780,543814742
2021-08-04,14108478,532117505,12800,2650700,11795615,543913120
2021-08-05,8546122,532932393,52700,2693400,11904828,544837221
2021-08-06,17645630,537847448,12700,2706000,12122880,549970328
2021-08-09,14623552,538557581,40400,2736400,12450620,551008201
2021-08-10,15249743,534616772,24300,2733500,12410090,547026862
2021-08-11,29847363,534910515,25900,2634600,12382620,547293135
2021-08-12,31175922,520340465,71400,2687300,13302135,533642600
2021-08-13,34155410,521443829,20500,2590600,12978906,534422735
2021-08-16,17385229,521461414,8500,2566400,12883328,534344742
2021-08-17,16971606,511051882,292100,2772400,13723380,524775262
2021-08-18,15157164,508268006,123400,2874600,14315508,522583514
2021-08-19,15558850,494117126,0,2858700,14264913,508382039
2021-08-20,15241649,487760908,314600,3159100,16016637,503777545
2021-08-23,29651509,500067081,16400,2911300,14585613,514652694
2021-08-24,27412559,504910983,249200,3160500,16244970,521155953
2021-08-25,25668546,511400992,22600,2914800,15069516,526470508
2021-08-26,67774992,524364263,210000,3109300,16448197,540812460
2021-08-27,24958191,515448730,269200,3315500,17804235,533252965
2021-08-30,31368440,521569564,362000,3675400,19883914,541453478
2021-08-31,52157965,535710087,5500,3561500,19588250,555298337
2021-09-01,37261318,519079951,27900,3575300,19485385,538565336
2021-09-02,37587829,526819462,128000,3432800,19017712,545837174
2021-09-03,33353144,522934141,305900,3729300,20958666,543892807
2021-09-06,47043478,539687740,285800,3885900,21955335,561643075
2021-09-07,29164105,514628082,5400,3355400,19729752,534357834
2021-09-08,29350537,517294984,285700,3387300,20120562,537415546
2021-09-09,53789941,489786714,182900,3347700,21860481,511647195
2021-09-10,115913149,533239973,293800,3583100,23361812,556601785
2021-09-13,115752289,580942390,126000,3621700,24265390,605207780
2021-09-14,67826647,565273939,58200,3298800,21145308,586419247
2021-09-15,27442226,546218006,64000,3292200,21201768,567419774
2021-09-16,40906158,533805154,6900,3280100,20828635,554633789
2021-09-17,32382691,533545029,141500,3349900,20367392,553912421
2021-09-22,24740142,547738599,69300,3041100,18763587,566502186
2021-09-23,20113501,535889915,301400,3331000,20785440,556675355
2021-09-24,20139495,537053335,278400,3430500,20445780,557499115
2021-09-27,28360460,522448862,87400,3476500,19051220,541500082
2021-09-28,28006533,524905221,14500,3454400,19171920,544077141
2021-09-29,17389103,520136365,42500,3458900,18124636,538261001
2021-09-30,13219143,523593433,85000,3438900,18123003,541716436
2021-10-08,19214740,532103996,85000,3448300,18207024,550311020
2021-10-11,15288893,525727312,375600,3782000,19968960,545696272
2021-10-12,21082850,531799446,55400,3774700,18911247,550710693
2021-10-13,15182733,503707455,46000,3783600,18728820,522436275
2021-10-14,10545717,503799270,36500,3757900,18751921,522551191
2021-10-15,9745964,506162105,54100,3681500,18223425,524385530
2021-10-18,21113431,514822073,36500,3680800,18404000,533226073
2021-10-19,9425021,510024982,349040,3674040,18627383,528652365
2021-10-20,9584053,510163852,286800,3935340,19755407,529919259
2021-10-21,9553271,499844768,45400,3645440,18190746,518035514
2021-10-22,12423181,497240169,41300,3239840,15421638,512661807
2021-10-25,6419319,488293386,35900,2927740,13965320,502258706
2021-10-26,5917067,482542700,48000,2932440,13841117,496383817
2021-10-27,6522637,480319978,65200,2857040,13113814,493433792
2021-10-28,8793451,473075170,36500,2857040,12828110,485903280
2021-10-29,18026810,476004861,36600,2809240,12444933,488449794
2021-11-01,10567812,473796962,31300,2556752,11377546,485174508
2021-11-02,15903724,476603889,113500,2614140,11162378,487766267
2021-11-03,14430560,482038801,36500,2597740,11118327,493157128
2021-11-04,21318975,485615989,48400,2532640,10637088,496253077
2021-11-05,15587314,485692308,102200,2598340,10549260,496241568
2021-11-08,15933784,490518428,211900,2652400,10715696,501234124
2021-11-09,13113915,497240802,249300,2651000,10604000,507844802
2021-11-10,26641471,499365343,437516,2839704,11415610,510780953
2021-11-11,29422673,503238965,367900,2974504,12165721,515404686
2021-11-12,19208135,503991229,221700,2980304,11831807,515823036
2021-11-15,15434069,507296869,279200,2974804,11869468,519166337
2021-11-16,12177774,504899161,93400,2996904,11747864,516647025
2021-11-17,6955634,505113636,90800,3009804,11918824,517032460
2021-11-18,22830042,512240176,285400,2975500,11842490,524082666
2021-11-19,21842105,505219193,81800,2859499,11723946,516943139
2021-11-22,22275380,506825491,96900,2911799,11967494,518792985
2021-11-23,24828558,508178983,203300,3006299,12626456,520805439
2021-11-24,17140960,511242612,89200,2973299,12487856,523730468
2021-11-25,12932357,511814860,56700,2648559,11044491,522859351
2021-11-26,15732497,512500251,102000,2600459,10843914,523344165
2021-11-29,8161705,505640806,80800,2406059,9840781,515481587
2021-11-30,6870482,498116748,371678,2521137,10336662,508453410
2021-12-01,5578277,497921846,36100,2060237,8549984,506471830
2021-12-02,11773468,496155618,198700,1963737,8247696,504403314
2021-12-03,11139738,489958312,48300,1632837,6857916,496816228
2021-12-06,14571005,488114361,108300,1510937,6330826,494445187
2021-12-07,20387681,489094886,15200,1323677,5665338,494760224
2021-12-08,10764311,489283682,109700,1402777,6003886,495287568
2021-12-09,10172257,490515981,1200,1276377,5424603,495940584
2021-12-10,9490473,488951629,0,1198977,5047693,493999322
2021-12-13,12114429,494360128,0,1185437,5014399,499374527
2021-12-14,10132358,498791992,2800,1153237,4797466,503589458
2021-12-15,6973482,493413530,149800,1118959,4688438,498101968
2021-12-16,23569949,491484930,323400,1434059,6223816,497708746
2021-12-17,20097688,492491516,205500,1479759,6392559,498884075
2021-12-20,12097643,487958511,117100,1536159,6574761,494533272
2021-12-21,13915028,474929332,184861,1721020,7520858,482450190
2021-12-22,23288177,479386170,225400,1923420,8405346,487791516
2021-12-23,44843320,474935249,393800,2317220,11145828,486081077
2021-12-24,78508304,488892150,444500,2661020,12134251,501026401
2021-12-27,85444766,496020642,1667312,4327832,21725716,517746358
2021-12-28,107180281,535022333,247500,3844020,18451296,553473629
2021-12-29,85435652,541242663,1304620,4936140,24335171,565577834
