日期,融资买入额(元),融资余额(元),融券卖出量,融券余量,融券余额(元),融资融券余额(元)
2019-08-19,14898870,14263420,0,0,0,14263420
2019-08-20,9381810,18601752,0,0,0,18601752
2019-08-21,15150288,26456968,0,0,0,26456968
2019-08-22,11535923,29719971,0,0,0,29719971
2019-08-23,9525619,30806501,0,0,0,30806501
2019-08-26,5450169,31987769,0,0,0,31987769
2019-08-27,7374083,34345987,5000,5000,64850,34410837
2019-08-28,4222761,34288965,0,5000,64500,34353465
2019-08-29,8165624,34754590,0,5000,64000,34818590
2019-08-30,6845669,36924686,0,5000,62750,36987436
2019-09-02,7663415,39913684,0,5000,64300,39977984
2019-09-03,12642456,45454146,0,5000,65200,45519346
2019-09-04,16701337,50469161,0,5000,67000,50536161
2019-09-05,31019812,62165134,0,5000,68350,62233484
2019-09-06,14995978,60854323,5000,10000,136200,60990523
2019-09-09,14481057,52230562,0,10000,141400,52371962
2019-09-10,15754607,55952805,0,10000,139700,56092505
2019-09-11,15187152,58975206,0,10000,137500,59112706
2019-09-12,12820864,62498986,0,10000,137900,62636886
2019-09-16,14913996,68914910,0,10000,138600,69053510
2019-09-17,14809108,73319947,0,10000,135000,73454947
2019-09-18,12234293,72962880,0,10000,132400,73095280
2019-09-19,29589163,84189592,0,10000,140200,84329792
2019-09-20,17850865,82323458,0,10000,139200,82462658
2019-09-23,24561991,92909863,0,10000,141200,93051063
2019-09-24,52772745,116477203,0,10000,144400,116621603
2019-09-25,35993528,127545500,0,10000,141600,127687100
2019-09-26,29642102,130953352,0,10000,140600,131093952
2019-09-27,46293627,128359058,0,10000,148500,128507558
2019-09-30,30285865,120814046,0,10000,142400,120956446
2019-10-08,30408495,132800800,23600,33600,486864,133287664
2019-10-09,41382790,142038685,19976,29976,447541,142486226
2019-10-10,42086255,146818171,0,29976,446042,147264213
2019-10-11,25964957,137179035,0,29976,432253,137611288
2019-10-14,34946455,145606672,0,29976,442146,146048818
2019-10-15,40055121,140058752,0,29976,404076,140462828
2019-10-16,10010268,138730887,700,30676,409831,139140718
2019-10-17,9170487,137308244,0,10700,142524,137450768
2019-10-18,7599990,134094817,0,10700,139421,134234238
2019-10-21,4362222,132188865,0,10700,141026,132329891
2019-10-22,10995747,135326322,1700,12400,165292,135491614
2019-10-23,5198323,129101952,0,12400,162068,129264020
2019-10-24,4228851,127495573,0,12400,161448,127657021
2019-10-25,7269800,126439312,0,11700,151866,126591178
2019-10-28,10313388,126440360,700,12400,164424,126604784
2019-10-29,10889799,124566778,0,12400,160332,124727110
2019-10-30,5773991,122919626,0,12400,159216,123078842
2019-10-31,6115985,119182065,0,12400,155992,119338057
2019-11-01,9370210,119287543,0,12400,159960,119447503
2019-11-04,9213814,120990199,0,12400,158472,121148671
2019-11-05,6956967,117991688,0,12400,157232,118148920
2019-11-06,5923663,117247307,0,12400,158472,117405779
2019-11-07,13696329,119958533,0,10700,140384,120098917
2019-11-08,8586816,119332471,1700,12400,159340,119491811
2019-11-11,6975753,118254368,0,12400,156488,118410856
2019-11-12,3525925,116850879,0,12400,157108,117007987
2019-11-13,1905541,116130747,0,12400,156240,116286987
2019-11-14,6494677,117156133,0,12400,158224,117314357
2019-11-15,5291096,114511301,0,12400,154628,114665929
2019-11-18,2686816,113477953,0,12400,155124,113633077
2019-11-19,5360705,113723630,0,12400,157728,113881358
2019-11-20,17698731,116909893,0,12400,162192,117072085
2019-11-21,8980747,119464351,0,12400,161944,119626295
2019-11-22,8520289,116618485,0,12400,158472,116776957
2019-11-25,4353233,116945111,0,12400,159588,117104699
2019-11-26,5312023,116805820,0,12400,159960,116965780
2019-11-27,8817017,117595744,0,10000,129000,117724744
2019-11-28,6370550,115860090,0,10000,129100,115989190
2019-11-29,8766115,118595130,0,10000,130300,118725430
2019-12-02,7074390,120769816,0,10000,130500,120900316
2019-12-03,8077329,120846331,0,10000,130900,120977231
2019-12-04,16689883,126674916,0,10000,131600,126806516
2019-12-05,12811322,126533675,0,10000,132600,126666275
2019-12-06,8419689,127735872,0,10000,132100,127867972
2019-12-09,10572084,125193561,0,10000,130500,125324061
2019-12-10,12823722,128227487,0,10000,130500,128357987
2019-12-11,19384301,138425239,0,10000,132000,138557239
2019-12-12,39984726,141903931,0,10000,136100,142040031
2019-12-13,21638383,141038000,0,10000,137300,141175300
2019-12-16,29584310,146291985,0,10000,140800,146432785
2019-12-17,15966656,141059417,0,10000,140100,141199517
2019-12-18,21255654,144030881,0,10000,140100,144170981
2019-12-19,13906345,146100817,0,10000,139900,146240717
2019-12-20,12790447,142926611,0,10000,136600,143063211
2019-12-23,36854493,144699778,0,10000,138700,144838478
2019-12-24,48303444,154629490,0,10000,146700,154776190
2019-12-25,56885479,158833147,0,10000,147500,158980647
2019-12-26,77064964,180370409,0,10000,155800,180526209
2019-12-27,57531328,190237237,0,10000,151200,190388437
2019-12-30,31733534,190260140,23600,28600,426140,190686280
2019-12-31,30584467,203171916,20000,48600,726570,203898486
2020-01-02,46416575,201831320,0,28600,435292,202266612
2020-01-03,32769529,199695362,0,28600,433862,200129224
2020-01-06,45413215,209574161,20000,48600,750870,210325031
2020-01-07,33392620,203874135,0,48600,743580,204617715
2020-01-08,35984234,200704195,0,48600,711018,201415213
2020-01-09,18579614,199362112,0,43600,653564,200015676
2020-01-10,18638432,194546295,0,43600,645280,195191575
2020-01-13,38594325,201587967,0,43600,671876,202259843
2020-01-14,65873267,203804107,0,43600,684956,204489063
2020-01-15,26454437,204639735,0,43600,682340,205322075
2020-01-16,54959875,223926838,0,43600,708063,224634901
2020-01-17,57823800,240971395,0,43600,697600,241668995
2020-01-20,59403781,255070658,0,43600,708936,255779594
2020-01-21,41569710,231778367,0,43600,708500,232486867
2020-01-22,71695052,250572940,0,20000,339000,250911940
2020-01-23,59772450,238072092,0,20000,316200,238388292
2020-02-03,7859229,227844893,0,20000,284600,228129493
2020-02-04,39858545,225925406,0,20000,291800,226217206
2020-02-05,47483826,228978581,0,20000,291000,229269581
2020-02-06,32060181,229130991,0,20000,299000,229429991
2020-02-07,50110330,238290143,0,20000,310600,238600743
2020-02-10,51602908,252584037,0,20000,315800,252899837
2020-02-11,42451060,261138555,0,0,0,261138555
2020-02-12,55381983,278350495,20000,20000,323000,278673495
2020-02-13,84326176,307786320,0,0,0,307786320
2020-02-14,188229388,385652189,22000,22000,397980,386050169
2020-02-17,97863570,403841180,0,22000,410080,404251260
2020-02-18,145325284,456024323,15000,37000,758500,456782823
2020-02-19,186692468,516168827,5600,7600,163780,516332607
2020-02-20,169544079,554243221,37913,42413,967016,555210237
2020-02-21,146099995,551588637,0,32000,743360,552331997
2020-02-24,153119512,565828670,10000,22000,506660,566335330
2020-02-25,218381622,597492810,23600,35600,885728,598378538
2020-02-26,112257629,554104091,10000,37000,828430,554932521
2020-02-27,65928709,539583617,0,22000,463760,540047377
2020-02-28,102203249,481994095,23600,45600,928416,482922511
2020-03-02,93818771,496256718,0,29600,624856,496881574
2020-03-03,76086766,486878568,0,22000,463100,487341668
2020-03-04,39497399,475289637,5000,27000,566730,475856367
2020-03-05,56882100,484020205,0,22000,454300,484474505
2020-03-06,40183044,483064752,0,22000,455840,483520592
2020-03-09,53559665,482638056,8300,30300,581760,483219816
2020-03-10,50796865,454504239,15300,37300,764650,455268889
2020-03-11,63395447,474083209,8300,37300,725858,474809067
2020-03-12,28343277,468802725,0,29000,552450,469355175
2020-03-13,37297329,451276227,16600,38600,770070,452046297
2020-03-16,54145332,378911225,7000,45600,853176,379764401
2020-03-17,95611061,408304499,0,29000,596820,408901319
2020-03-18,161669620,454228691,13300,35300,746948,454975639
2020-03-19,175453455,476311030,10300,45600,1061568,477372598
2020-03-20,321730893,557850925,0,22000,563420,558414345
2020-03-23,142277439,547951245,23600,45600,1051080,549002325
2020-03-24,147444507,489122607,0,22000,474980,489597587
2020-03-25,140449263,499104670,16600,38600,815618,499920288
2020-03-26,65733997,478935316,7000,29000,591020,479526336
2020-03-27,52102235,462538828,12100,34100,668360,463207188
2020-03-30,53351969,427412937,0,30300,572670,427985607
2020-03-31,54435474,409391643,0,30300,572670,409964313
2020-04-01,51601896,405203440,7200,29200,556552,405759992
2020-04-02,64406756,417789664,21600,50800,1028192,418817856
2020-04-03,62979898,414808906,0,27200,526320,415335226
2020-04-07,60358159,427445914,7000,34000,678300,428124214
2020-04-08,53416489,423977378,0,29000,582030,424559408
2020-04-09,49930758,421029135,5000,34000,670820,421699955
2020-04-10,51441255,404611285,16600,30600,543456,405154741
2020-04-13,21008764,398156927,0,30600,524790,398681717
2020-04-14,18468065,396751543,0,7000,123200,396874743
2020-04-15,26957795,391892161,5000,12000,207600,392099761
2020-04-16,32470901,400251277,600,2600,45994,400297271
2020-04-17,38605981,403202917,12000,14600,260318,403463235
2020-04-20,16656098,390827307,10000,24600,442308,391269615
2020-04-21,21437800,389535269,0,14000,250460,389785729
2020-04-22,42927650,395383757,26600,28600,532532,395916289
2020-04-23,37379904,409330839,0,28600,510796,409841635
2020-04-24,17960425,393818990,0,18600,321594,394140584
2020-04-27,10379246,388111430,20000,38600,663920,388775350
2020-04-28,34504218,392546823,0,13500,234900,392781723
2020-04-29,23876122,397229915,39100,52600,917870,398147785
2020-04-30,50062112,400771276,13000,37300,687439,401458715
2020-05-06,72247192,401579458,28300,43600,858920,402438378
2020-05-07,66185413,403857859,11100,26400,519288,404377147
2020-05-08,62884497,386813558,47200,68600,1356222,388169780
2020-05-11,51055366,375487331,5000,29100,570069,376057400
2020-05-12,58235479,380885823,40800,49100,959414,381845237
2020-05-13,61633300,384516231,0,3800,75050,384591281
2020-05-14,60773776,390165446,74800,78600,1548420,391713866
2020-05-15,67011397,393797264,0,31100,624488,394421752
2020-05-18,81058521,400503437,47500,62800,1245324,401748761
2020-05-19,135652779,420761723,15800,20800,453648,421215371
2020-05-20,169729125,426959619,57800,57800,1255994,428215613
2020-05-21,94908877,420279825,8700,23200,473280,420753105
2020-05-22,55830753,423554714,43300,66500,1304730,424859444
2020-05-25,89872100,430566505,5000,28600,589160,431155665
2020-05-26,85521819,434381236,50000,65300,1356934,435738170
2020-05-27,136442898,469476011,13300,38173,802015,470278026
2020-05-28,77955404,463055904,35000,42000,864780,463920684
2020-05-29,51917783,450905302,21600,28600,591734,451497036
2020-06-01,88500085,436182729,50000,66600,1439226,437621955
2020-06-02,167117667,494927996,12000,20300,446397,495374393
2020-06-03,388010307,655297891,58300,58300,1383459,656681350
2020-06-04,162728804,684166510,23300,44100,998865,685165375
2020-06-05,141131508,671682265,44500,61100,1383304,673065569
2020-06-08,104160999,614872245,20000,43600,947864,615820109
2020-06-09,67684157,561756801,45000,68600,1527722,563284523
2020-06-10,76153594,571785819,20000,54200,1181018,572966837
2020-06-11,75265593,580672781,30000,61700,1358634,582031415
2020-06-12,50720142,560134510,5000,29700,640035,560774545
2020-06-15,68775156,519415190,47000,71700,1522191,520937381
2020-06-16,47611012,512517990,10000,41700,906975,513424965
2020-06-17,62603445,503437893,0,23400,489294,503927187
2020-06-18,35310465,503530637,60000,83400,1737222,505267859
2020-06-19,27917174,496812047,0,0,0,496812047
2020-06-22,80117840,506199899,100221,100221,2195842,508395741
2020-06-23,41567752,497572026,0,20000,433800,498005826
2020-06-24,53899624,490096282,67000,82000,1778580,491874862
2020-06-29,46983204,482739736,20300,34800,721752,483461488
2020-06-30,39959906,476924177,45000,74800,1579776,478503953
2020-07-01,47367791,477828514,8500,23000,475410,478303924
2020-07-02,56968955,483345066,56985,61985,1319041,484664107
2020-07-03,63360899,486774823,34700,39700,867842,487642665
2020-07-06,93432568,494023319,49500,49500,1132065,495155384
2020-07-07,129785306,504320451,59100,59100,1351026,505671477
2020-07-08,98174392,511768616,31700,31700,745584,512514200
2020-07-09,74948190,486260848,46600,48300,1249521,487510369
2020-07-10,272091340,583415846,55300,55300,1545082,584960928
2020-07-13,202489595,612857530,53300,58600,1682992,614540522
2020-07-14,158000842,635845481,0,15000,412500,636257981
2020-07-15,90865397,613187573,23523,23523,619125,613806698
2020-07-16,87367769,608970325,15000,15000,378000,609348325
2020-07-17,48090935,578884839,15300,15300,375768,579260607
2020-07-20,53011612,574410407,28300,28300,713443,575123850
2020-07-21,59873033,589725312,7000,8300,202437,589927749
2020-07-22,65084409,583884267,47000,48300,1209915,585094182
2020-07-23,54952464,562300672,9000,34000,846940,563147612
2020-07-24,47309752,543349449,102400,102400,2375680,545725129
2020-07-27,25838546,538357481,40000,108000,2465640,540823121
2020-07-28,23992860,530040679,32200,100200,2335662,532376341
2020-07-29,37452594,527509399,140500,173500,4216050,531725449
2020-07-30,42224609,539553110,26500,97000,2286290,541839400
2020-07-31,42125001,539462563,85800,175800,4252602,543715165
2020-08-03,71662169,548394365,15300,132800,3397024,551791389
2020-08-04,57246900,540882774,68000,185500,4717265,545600039
2020-08-05,70077076,552247234,62500,183000,4639050,556886284
2020-08-06,49068741,549557398,75500,248000,6150400,555707798
2020-08-07,45591572,532720073,3000,175500,4080375,536800448
2020-08-10,30173294,528066578,68000,230500,5435190,533501768
2020-08-11,25613698,523413173,23300,185800,4301270,527714443
2020-08-12,25411494,520366879,48000,186300,4297941,524664820
2020-08-13,22091418,518063828,0,144800,3381080,521444908
2020-08-14,27838555,517941096,22780,161080,3759607,521700703
2020-08-17,30432372,516639858,50000,153980,3670883,520310741
2020-08-18,31717760,521885446,15900,113380,2666698,524552144
2020-08-19,38307632,507194770,15900,120680,2632031,509826801
2020-08-20,22941551,517483292,43680,148460,3224552,520707844
2020-08-21,16009452,507014267,0,91780,1981530,508995797
2020-08-24,25230744,513015545,70800,149580,3286273,516301818
2020-08-25,29819677,519512319,6500,92880,2058221,521570540
2020-08-26,27614724,510462958,30000,91300,1906344,512369302
2020-08-27,23493398,507034343,113200,201500,4390685,511425028
2020-08-28,34646790,508151412,13000,130500,2908845,511060257
2020-08-31,26655671,508440789,21500,125800,2751246,511192035
2020-09-01,16976886,508868214,16500,119100,2636874,511505088
2020-09-02,27127567,505133841,3000,105600,2352768,507486609
2020-09-03,53608301,518442187,64800,167400,3843504,522285691
2020-09-04,65602152,515724845,29900,142100,3399032,519123877
2020-09-07,66617541,524813888,24700,156900,3618114,528432002
2020-09-08,56125226,524089837,20200,148900,3193905,527283742
2020-09-09,34895084,522055912,84500,205900,4220950,526276862
2020-09-10,27025891,522410293,73800,255200,4945776,527356069
2020-09-11,14512342,521142699,79900,304700,6057436,527200135
2020-09-14,22844427,525483838,58900,328800,6756840,532240678
2020-09-15,24832355,520175846,32200,324500,6730130,526905976
2020-09-16,15278974,512199431,0,309500,6270470,518469901
2020-09-17,62936229,520886006,89200,369200,8063328,528949334
2020-09-18,42985320,520360878,29500,347200,7509936,527870814
2020-09-21,28844258,528459652,25000,307700,6520163,534979815
2020-09-22,20103314,526847233,0,279400,5747258,532594491
2020-09-23,39654368,507840612,126300,349700,7749352,515589964
2020-09-24,41916776,516989618,14300,319500,6942735,523932353
2020-09-25,28295050,514732044,83600,383100,8041269,522773313
2020-09-28,15671543,511234647,6500,372700,7554629,518789276
2020-09-29,53917480,515145239,105800,458500,10077830,525223069
2020-09-30,30960362,502600310,400,388600,8354900,510955210
2020-10-09,73689446,529034889,55278,408878,9187489,538222378
2020-10-12,103655257,561129106,55000,407300,9473798,570602904
2020-10-13,54564509,565744458,3000,395300,9016793,574761251
2020-10-14,57266995,569277708,83559,453659,10098449,579376157
2020-10-15,43247538,570646138,0,418700,9131847,579777985
2020-10-16,20758658,555130160,87000,494900,10887800,566017960
2020-10-19,28506626,538848180,0,459900,9722286,548570466
2020-10-20,17427517,534732234,56425,506325,10840418,545572652
2020-10-21,25660059,502535991,9400,515725,10237141,512773132
2020-10-22,15591610,496295164,107000,589725,11900651,508195815
2020-10-23,27865231,506047855,0,534725,10715889,516763744
2020-10-26,18071306,514488180,12000,546725,10961836,525450016
2020-10-27,17825523,521164657,1800,544625,10865269,532029926
2020-10-28,22514921,527799432,3900,536200,10831240,538630672
2020-10-29,14316002,526960249,5000,511700,10320989,537281238
2020-10-30,28268056,528872077,86900,598600,11960028,540832105
2020-11-02,25249945,504933138,40000,576800,10428544,515361682
2020-11-03,21373320,504193493,71800,637700,12052530,516246023
2020-11-04,18916094,512824093,900,582600,10970358,523794451
2020-11-05,12812185,511379335,10000,542000,10384720,521764055
2020-11-06,19685947,508084596,95300,615600,11604060,519688656
2020-11-09,32555572,507125576,41500,543600,10893744,518019320
2020-11-10,32212153,507650182,32000,545300,11020513,518670695
2020-11-11,11927059,498381815,900,504700,9912308,508294123
2020-11-12,10207730,497990883,0,503800,9718302,507709185
2020-11-13,8863717,495653135,73300,549100,10767851,506420986
2020-11-16,8095553,492129115,0,497100,9618885,501748000
2020-11-17,8766260,487465988,32980,520080,9995938,497461926
2020-11-18,8036193,487052076,21500,492900,9453822,496505898
2020-11-19,7565089,486229404,39000,497800,9532870,495762274
2020-11-20,6255688,482701628,5900,483700,9175789,491877417
2020-11-23,7462670,478028591,5400,486500,9146200,487174791
2020-11-24,19102368,487881542,42600,516500,9911635,497793177
2020-11-25,28427546,497293566,42200,523700,9986959,507280525
2020-11-26,19726680,494646454,600,521300,9763949,504410403
2020-11-27,12581375,477325252,20000,496700,9089610,486414862
2020-11-30,12813686,466925647,0,479100,8724411,475650058
2020-12-01,15742717,464975010,0,459100,8429076,473404086
2020-12-02,15687749,457600928,129400,573500,10793270,468394198
2020-12-03,9110051,455997374,0,488200,9095166,465092540
2020-12-04,16155433,458297172,26900,490100,9302098,467599270
2020-12-07,17566975,461499078,35000,501100,9510878,471009956
2020-12-08,12037078,459381173,0,488100,9083541,468464714
2020-12-09,9079090,456635731,0,478100,8734887,465370618
2020-12-10,7455965,458879714,2500,480600,8790174,467669888
2020-12-11,10773524,451507261,43000,516100,9238190,460745451
2020-12-14,5132391,448505825,0,473200,8446620,456952445
2020-12-15,5083652,442820900,2900,476100,8579322,451400222
2020-12-16,13724203,440008769,0,461800,8063028,448071797
2020-12-17,8729296,428998791,0,456900,8137389,437136180
2020-12-18,21970508,440020391,3900,460800,8266752,448287143
2020-12-21,15675719,444071936,0,460800,8474112,452546048
2020-12-22,7841108,437871369,0,460800,8142336,446013705
2020-12-23,7642877,437224516,0,457800,8222088,445446604
2020-12-24,11332291,434887002,3000,460800,7902720,442789722
2020-12-25,8220145,432558633,0,457800,7782600,440341233
2020-12-28,7028456,431478251,3500,461300,7583772,439062023
2020-12-29,6227116,425188030,7200,468000,7890480,433078510
2020-12-30,4572675,425175264,7100,462100,7864942,433040206
2020-12-31,7824986,422165064,7200,456200,8102112,430267176
2021-01-04,9653589,414536421,18900,467900,8398805,422935226
2021-01-05,12455525,412504432,7200,440000,7999200,420503632
2021-01-06,9363939,406455491,7100,427900,7552435,414007926
2021-01-07,13798679,407441614,7200,428000,7228920,414670534
2021-01-08,32471051,425337570,19100,413900,7321891,432659461
2021-01-11,11221656,420850955,17200,424000,7526000,428376955
2021-01-12,17350893,410785277,7100,411900,7088799,417874076
2021-01-13,13087214,406567216,14800,420600,7200672,413767888
2021-01-14,26152550,407695750,14200,372600,6766416,414462166
2021-01-15,20492179,414462014,10000,352200,6269160,420731174
2021-01-18,24916908,420698667,32200,371600,6766836,427465503
2021-01-19,18872626,422919333,31400,353400,6428346,429347679
2021-01-20,15135842,421803534,25600,372000,6718320,428521854
2021-01-21,18998080,419014045,13100,343500,6165825,425179870
2021-01-22,21548011,418494900,16100,346500,5904360,424399260
2021-01-25,10248819,416592653,12600,336800,5624560,422217213
2021-01-26,13982035,416943492,15400,333000,5394600,422338092
2021-01-27,13259556,416843744,23100,335300,5197150,422040894
2021-01-28,7335052,415621272,13035,320935,4849328,420470600
2021-01-29,12802899,417250015,19000,319900,4731321,421981336
2021-02-01,6843847,414425030,7000,317000,4726470,419151500
2021-02-02,7131426,405904827,3900,314500,4789835,410694662
2021-02-03,8787525,404139341,26900,340100,5016475,409155816
2021-02-04,7302370,392635657,2200,331400,4695938,397331595
2021-02-05,4655699,390160358,7000,300900,4245699,394406057
2021-02-08,4394281,388370264,0,293900,4129295,392499559
2021-02-09,4038631,387391770,0,293900,4211587,391603357
2021-02-10,2940152,376546898,0,293900,4249794,380796692
2021-02-18,8550419,377702936,12000,305900,4588500,382291436
2021-02-19,6512753,374949820,6900,300800,4644352,379594172
2021-02-22,16234167,377985915,32400,326300,5051124,383037039
2021-02-23,6747954,379162134,7000,314400,4794600,383956734
2021-02-24,12605467,381504167,31300,338800,5254788,386758955
2021-02-25,7558267,377568282,10600,342500,5171750,382740032
2021-02-26,4175021,370857009,5600,329600,4894560,375751569
2021-03-01,6899328,368617961,16500,340100,5237540,373855501
2021-03-02,15021790,374363913,9300,320400,4930956,379294869
2021-03-03,4520484,371624495,6900,278700,4305915,375930410
2021-03-04,14890916,376714312,18900,290700,4505850,381220162
2021-03-05,8648796,374439243,46900,285800,4538504,378977747
2021-03-08,13831425,378271799,18800,247100,3802869,382074668
2021-03-09,6580001,374340944,22500,255400,3884634,378225578
2021-03-10,7652043,371742275,30600,275700,3983865,375726140
2021-03-11,5992989,370530680,13700,268800,3980928,374511608
2021-03-12,2901062,368036149,19800,279500,4063930,372100079
2021-03-15,1786584,366550780,13800,277200,4011084,370561864
2021-03-16,4710480,365963748,29500,286200,4270104,370233852
2021-03-17,16460230,370605107,20500,294200,4565984,375171091
2021-03-18,17347857,376107175,13800,288000,4492800,380599975
2021-03-19,11582732,376152397,97900,371700,5798520,381950917
2021-03-22,9707272,378245465,13800,359700,5593335,383838800
2021-03-23,35993654,375883269,1025800,1371700,22386144,398269413
2021-03-24,18277907,374441186,513800,1859800,29384840,403826026
2021-03-25,17502207,382710736,358200,2204200,34583898,417294634
2021-03-26,14589416,387397615,1093900,3284300,51793411,439191026
2021-03-29,14483007,390203957,71200,3322200,52590426,442794383
2021-03-30,14924976,385812536,50800,3308700,49961370,435773906
2021-03-31,5508319,385042309,34300,3263600,49541448,434583757
2021-04-01,6908130,380659874,32800,3201600,48600288,429260162
2021-04-02,17429576,381686442,43500,3187600,50619088,432305530
2021-04-06,14559630,381918115,34700,3180400,51395264,433313379
2021-04-07,6427873,379594428,38200,3188200,50883672,430478100
2021-04-08,7668873,377583431,25100,3198200,50467596,428051027
2021-04-09,7701708,376957313,86881,3209381,51093346,428050659
2021-04-12,10376493,377778999,63600,3217781,49071160,426850159
2021-04-13,4020037,376797565,39200,3206681,48966019,425763584
2021-04-14,3405643,374820209,19000,3193881,49505156,424325365
2021-04-15,5816706,375906855,36900,3195081,48884739,424791594
2021-04-16,7768992,371032351,42300,3190281,49002716,420035067
2021-04-19,11880805,370866094,53900,3199900,50462423,421328517
2021-04-20,9124521,370907766,41500,3197600,49498848,420406614
2021-04-21,4306657,363738919,44100,3166200,48474522,412213441
2021-04-22,6218544,362557770,41600,3166400,48477584,411035354
2021-04-23,5925992,358344421,80100,3195100,47830647,406175068
2021-04-26,4091045,355754007,56100,3179600,47725796,403479803
2021-04-27,10710777,357431794,59900,3178100,46082450,403514244
2021-04-28,3442088,357739520,46200,3172800,46449792,404189312
2021-04-29,9326890,357253325,38000,3150500,46847935,404101260
2021-04-30,3109579,349903862,14600,3124800,46153296,396057158
2021-05-06,4011455,351304689,8000,3124100,46080475,397385164
2021-05-07,4405761,350169309,11800,3070600,44646524,394815833
2021-05-10,6151621,350182649,12800,3061900,43662694,393845343
2021-05-11,4340474,350457388,20800,3001600,43012928,393470316
2021-05-12,4857022,349289586,19980,3002080,44160597,393450183
2021-05-13,5382997,349714238,0,2985550,43380041,393094279
2021-05-14,5906764,351412473,10600,2989750,44098813,395511286
2021-05-17,11062647,353749010,21100,3000000,44790000,398539010
2021-05-18,9518937,356936836,7300,2974700,43579355,400516191
2021-05-19,6004704,357719509,0,2951000,43232150,400951659
2021-05-20,8451777,359251102,1200,2948000,42038480,401289582
2021-05-21,3894127,359180820,1800,2949800,42152642,401333462
2021-05-24,5757828,360705444,6900,2947100,43057131,403762575
2021-05-25,8632684,359739590,400,2943700,43713945,403453535
2021-05-26,5832576,357548862,1100,2901300,43142331,400691193
2021-05-27,38122483,361671851,0,2892700,45907149,407579000
2021-05-28,18710296,360252122,13000,2905700,45968174,406220296
2021-05-31,30974264,373868419,0,2905700,46956112,420824531
2021-06-01,45482722,379647413,55400,2961100,49272704,428920117
2021-06-02,17651355,376255687,0,2893900,47546777,423802464
2021-06-03,14252394,371957488,0,2891100,47124930,419082418
2021-06-04,16277966,374545952,0,2891100,48021171,422567123
2021-06-07,25915283,377294186,2800,2893900,48791154,426085340
2021-06-08,15804668,369173319,0,2880000,47952000,417125319
2021-06-09,14472179,372101861,0,2880000,47980800,420082661
2021-06-10,15976571,375272042,0,2880000,48902400,424174442
2021-06-11,18354594,375858921,0,2880000,47404800,423263721
2021-06-15,17968132,381540288,3000,2883000,46704600,428244888
2021-06-16,17678584,388051143,0,2883000,46560450,434611593
2021-06-17,42563609,391122590,0,2880000,50630400,441752990
2021-06-18,34183267,397220189,3000,2883000,50913780,448133969
2021-06-21,73761822,419318539,0,2883000,53623800,472942339
2021-06-22,50349577,436795297,0,2883000,51865170,488660467
2021-06-23,64156105,446351169,0,2880800,53294800,499645969
2021-06-24,39762570,435287760,2200,2883000,54431040,489718800
2021-06-25,99825515,436473761,0,2880000,56620800,493094561
2021-06-28,114307103,467631170,3000,2883000,54171570,521802740
2021-06-29,49124692,477554788,0,2883000,52066980,529621768
2021-06-30,71911264,497761068,0,2880000,52214400,549975468
2021-07-01,42627191,476452799,3000,2883000,50625480,527078279
2021-07-02,33133165,474647018,0,2882800,49843612,524490630
2021-07-05,23354957,472781182,200,2880200,51037144,523818326
2021-07-06,30785210,470482511,0,2880200,51037144,521519655
2021-07-07,25535572,463547311,0,2880100,51870601,515417912
2021-07-08,60587423,458270667,0,2880100,54520293,512790960
2021-07-09,50356733,460587279,200,2880300,54984927,515572206
2021-07-12,80454695,491982375,0,2880000,54172800,546155175
2021-07-13,63163493,487829942,0,2880000,55785600,543615542
2021-07-14,32674223,485717245,3000,2883000,54056250,539773495
2021-07-15,27822229,480048861,0,2883000,55411260,535460121
2021-07-16,37489572,475222237,0,2880000,54691200,529913437
2021-07-19,24752414,469761697,3000,2883000,52585920,522347617
2021-07-20,21421087,467846596,0,2880000,52588800,520435396
2021-07-21,52094661,471711301,0,2880000,56361600,528072901
2021-07-22,90434632,490917817,3000,2883000,59966400,550884217
2021-07-23,42285554,445728363,0,2882100,58333704,504062067
2021-07-26,51758494,460997038,900,2880900,57013011,518010049
2021-07-27,104924401,501736116,0,2880000,57340800,559076916
2021-07-28,41963424,473792437,3000,2883000,54978810,528771247
2021-07-29,115255656,507422110,0,2882500,60993700,568415810
2021-07-30,141005236,528668503,500,2882000,63288720,591957223
2021-08-02,102365904,549877580,1000,2881000,61365300,611242880
2021-08-03,64751992,529939079,700,2881400,57800884,587739963
2021-08-04,54445340,529377948,172300,3053700,63272664,592650612
2021-08-05,36485452,530602729,113900,3112900,62818322,593421051
2021-08-06,66682867,538404361,129400,3234700,68187476,606591837
2021-08-09,51182135,538523834,70700,3269500,68594110,607117944
2021-08-10,75696054,539132644,88300,3270300,69166845,608299489
2021-08-11,87949140,556461295,66400,3331700,73164132,629625427
2021-08-12,77505769,547867604,39200,3258800,71400308,619267912
2021-08-13,50936250,534335333,13100,3246900,70587606,604922939
2021-08-16,46037319,536043750,19500,3241400,70435622,606479372
2021-08-17,52026008,528176283,52600,3154000,64215440,592391723
2021-08-18,33397836,532894706,70700,3206700,65480814,598375520
2021-08-19,27444519,527081716,73800,3275200,66748576,593830292
2021-08-20,24193900,521633485,25200,3247700,66902620,588536105
2021-08-23,37103490,525471898,41900,3271600,69128908,594600806
2021-08-24,38250198,525714277,5900,3272400,67935024,593649301
2021-08-25,33001651,528608919,8000,3225400,64991810,593600729
2021-08-26,34063393,527877676,5000,3222400,63449056,591326732
2021-08-27,17786411,523088752,5000,3222400,63159040,586247792
2021-08-30,45271242,519457208,8000,3186000,59514480,578971688
2021-08-31,20809723,518911594,5000,3101000,57554560,576466154
2021-09-01,18219079,515548321,8000,3104000,56430720,571979041
2021-09-02,12116370,513123244,5000,3101000,56407190,569530434
2021-09-03,27693108,515207855,7908,3103908,57422298,572630153
2021-09-06,16827870,511929337,5000,3104000,58106880,570036217
2021-09-07,15611676,508748024,4400,3101000,58267790,567015814
2021-09-08,26910250,506584621,5000,3101000,59477180,566061801
2021-09-09,23124720,500348453,8000,3104000,59224320,559572773
2021-09-10,30431687,502538732,26600,3125600,60292824,562831556
2021-09-13,18411034,484219445,4100,3125000,58656250,542875695
2021-09-14,13564033,470637996,1473900,4591500,83978535,554616531
2021-09-15,14458895,464828601,2024876,6611376,124888893,589717494
2021-09-16,16385047,467216795,919200,7525576,136890227,604107022
2021-09-17,14000365,456506271,3700,7521976,137802600,594308871
2021-09-22,10975788,453516611,953210,8472386,153096015,606612626
2021-09-23,31090967,472457569,2055216,9375102,166970567,639428136
2021-09-24,14865566,469067618,5900,8843602,154851471,623919089
2021-09-27,10279908,458885869,5000,8295902,139122277,598008146
2021-09-28,4444485,457435256,4200,7494802,125537934,582973190
2021-09-29,8244917,449271102,5000,7004802,112216929,561488031
2021-09-30,4356311,441016627,4000,7003802,113321517,554338144
2021-10-08,8820793,441619361,5000,7004802,114528513,556147874
2021-10-11,9074019,441140696,5000,7004802,115579233,556719929
2021-10-12,6260688,441755056,8000,7007802,113176002,554931058
2021-10-13,8518281,443250375,5000,7007802,115558655,558809030
2021-10-14,7819370,444834706,302200,7307802,121382591,566217297
2021-10-15,12645882,445930792,5000,7307802,123794165,569724957
2021-10-18,8040235,448668085,1800,7303102,123349393,572017478
2021-10-19,7636789,441402168,3000,7304702,124106887,565509055
2021-10-20,8521014,441614613,5000,7304802,124108586,565723199
2021-10-21,7351447,440581826,4000,7304102,123147159,563728985
2021-10-22,20523629,433261490,5000,7304802,127760987,561022477
2021-10-25,14656512,435179929,0,7299802,126651565,561831494
2021-10-26,13103689,434110108,3000,7302802,128018119,562128227
2021-10-27,14527816,435993972,0,7299802,126140578,562134550
2021-10-28,9360368,435994515,0,7299802,120957719,556952234
2021-10-29,16252025,420790160,0,7299802,129279493,550069653
2021-11-01,23555251,429147133,11200,7311002,132914017,562061150
2021-11-02,29440656,425237839,4500,7312502,134915662,560153501
2021-11-03,14176594,422101463,0,7312502,136231912,558333375
2021-11-04,16521511,425609980,2300,7314802,137225686,562835666
2021-11-05,29633306,424721915,3000,7317802,140135908,564857823
2021-11-08,16816423,424860132,80000,7379802,137854702,562714834
2021-11-09,18300072,428270005,7100,7386902,140203399,568473404
2021-11-10,16838280,427172717,3000,7382802,142266595,569439312
2021-11-11,29485101,420525801,88700,7468502,143320553,563846354
2021-11-12,26622404,428085269,7500,7414502,144434498,572519767
2021-11-15,17074519,433088498,2600,7414502,142358438,575446936
2021-11-16,18061332,431003388,7700,7414502,139170203,570173591
2021-11-17,16803703,429373887,7000,7414458,143766341,573140228
2021-11-18,17178917,425154678,165400,7494158,142613827,567768505
2021-11-19,15536631,426825948,4100,7490958,144500580,571326528
2021-11-22,46122489,446611720,8500,7488302,149092093,595703813
2021-11-23,32332869,447238849,8800,7490602,149662227,596901076
2021-11-24,28967567,446692931,0,7482802,147411199,594104130
2021-11-25,16082412,449920240,0,7482602,147332433,597252673
2021-11-26,21251981,448983897,23400,7503202,149313719,598297616
2021-11-29,44740222,471456636,7400,7413102,151820328,623276964
2021-11-30,19850964,468736277,4800,7322402,148644761,617381038
2021-12-01,61514270,472622669,7800,7323202,157668539,630291208
2021-12-02,49451168,488376246,10800,7326202,149747568,638123814
2021-12-03,40418124,481555378,7800,7326202,161176444,642731822
2021-12-06,52324237,493167823,7800,7326202,157220295,650388118
2021-12-07,57559865,520416522,7800,7326202,150113879,670530401
2021-12-08,46063656,545235814,5500,7323102,154663914,699899728
2021-12-09,37465093,546047408,3000,7318402,155296491,701343899
2021-12-10,23590007,542159964,0,7315402,156549602,698709566
2021-12-13,36787017,550516367,0,7315402,158817377,709333744
2021-12-14,62698820,582623931,3000,7318402,160712108,743336039
2021-12-15,39792133,590547805,0,7318402,155881963,746429768
2021-12-16,26375798,584430415,0,7017402,149470663,733901078
2021-12-17,31092806,585517471,65900,7083302,145136858,730654329
2021-12-20,13255470,563163706,63700,7147002,141796520,704960226
2021-12-21,12075364,553799113,49100,7195902,143774121,697573234
2021-12-22,15427080,555998835,37200,7233102,143938729,699937564
2021-12-23,48151781,540187389,42300,7275402,157948977,698136366
2021-12-24,31978978,542429172,10900,7274202,153194695,695623867
