日期,融资买入额(元),融资余额(元),融券卖出量,融券余量,融券余额(元),融资融券余额(元)
2017-07-12,18202060,166773199,3000,42900,372372,167145571
2017-07-13,9660665,166265081,16600,59500,518840,166783921
2017-07-14,11698110,166855271,6000,62900,545343,167400614
2017-07-17,17538445,169258997,15900,61900,523055,169782052
2017-07-18,4842890,164035540,39000,90900,785376,164820916
2017-07-19,11232191,156676185,83400,173300,1530239,158206424
2017-07-20,8732725,152294357,29000,182300,1606063,153900420
2017-07-21,16047582,134205225,19500,189500,1711185,135916410
2017-07-24,34156934,142434342,36900,216500,2017780,144452122
2017-07-25,8969146,139445905,20100,201600,1868832,141314737
2017-07-26,12035110,136383249,0,153100,1403927,137787176
2017-07-27,14352873,138379167,0,153100,1408520,139787687
2017-07-28,16971767,135236827,8200,161300,1506542,136743369
2017-07-31,17947266,136257497,3600,156700,1483949,137741446
2017-08-01,16743493,141704975,0,153100,1408520,143113495
2017-08-02,9800471,138940777,18400,171400,1583736,140524513
2017-08-03,26412685,132069614,204240,253340,2444731,134514345
2017-08-04,28401768,141483684,78900,140840,1343613,142827297
2017-08-07,13397547,138953123,2000,72000,687600,139640723
2017-08-08,17952147,141728984,8100,58100,543235,142272219
2017-08-09,7441735,142878203,14400,64400,596988,143475191
2017-08-10,12217049,144979263,6800,48900,449391,145428654
2017-08-11,19057337,136927839,6600,50600,452364,137380203
2017-08-14,10981556,138828126,3700,48600,440316,139268442
2017-08-15,13189565,140785495,8300,53400,482202,141267697
2017-08-16,7092426,143618311,26200,62300,561323,144179634
2017-08-17,11999665,138428564,100,51400,468254,138896818
2017-08-18,12752505,138104495,0,51400,469282,138573777
2017-08-21,7442060,138885023,3400,39600,364716,139249739
2017-08-22,8970070,140266092,0,36200,327972,140594064
2017-08-23,4591744,135727756,3000,39200,354368,136082124
2017-08-24,5414495,137190997,0,39200,353976,137544973
2017-08-25,14709582,143406815,1500,37700,344955,143751770
2017-08-28,16068327,150255181,1800,39500,366165,150621346
2017-08-29,13019843,137556930,2700,42200,386552,137943482
2017-08-30,8763018,133606859,1100,43300,399659,134006518
2017-08-31,12587243,135269976,100,40100,363707,135633683
2017-09-01,6592742,132571902,0,40100,366113,132938015
2017-09-04,12466039,138431502,23400,61600,556248,138987750
2017-09-05,3354574,135935707,1500,60400,547828,136483535
2017-09-06,10079913,130018385,4600,65000,601900,130620285
2017-09-07,16687480,136432581,0,65000,606450,137039031
2017-09-08,19079423,138284444,0,37300,340922,138625366
2017-09-11,20614521,139101429,4700,42000,396060,139497489
2017-09-12,29342923,147398665,0,37300,347263,147745928
2017-09-13,13537506,150751461,1000,38300,354658,151106119
2017-09-14,15598917,153770228,12300,45600,417240,154187468
2017-09-15,18549935,157259823,0,44300,399143,157658966
2017-09-18,9651120,158461422,4600,47900,433495,158894917
2017-09-19,10793550,159726926,0,47900,429184,160156110
2017-09-20,10716781,163551663,0,47900,430621,163982284
2017-09-21,4430143,160216318,0,47900,429184,160645502
2017-09-22,6558864,158024669,0,31200,279240,158303909
2017-09-25,4838368,155649249,0,30500,269620,155918869
2017-09-26,7069937,158607559,0,30500,267180,158874739
2017-09-27,2674458,156423435,0,30500,270535,156693970
2017-09-28,6500590,155841915,0,30500,267180,156109095
2017-09-29,2798176,150608262,0,300,2640,150610902
2017-10-09,16509484,160468444,0,300,2673,160471117
2017-10-10,11016262,159867717,0,300,2706,159870423
2017-10-11,9873332,157602523,64700,65000,579800,158182323
2017-10-12,6286480,150717449,0,65000,585000,151302449
2017-10-13,4635110,148825654,0,65000,583700,149409354
2017-10-16,7536581,146582296,0,300,2640,146584936
2017-10-17,4891904,147334387,0,300,2649,147337036
2017-10-18,6639668,144205194,19699,19999,172791,144377985
2017-10-19,13950947,155052638,300,20299,172542,155225180
2017-10-20,4448067,151532235,4900,5200,45032,151577267
2017-10-23,9031558,152417182,0,300,2613,152419795
2017-10-24,4701894,152408041,0,300,2607,152410648
2017-10-25,6831771,151715101,1000,1300,11375,151726476
2017-10-26,6717684,148912308,0,1300,11427,148923735
2017-10-27,4831302,141444305,1000,1300,11427,141455732
2017-10-30,7986590,143259166,0,300,2616,143261782
2017-10-31,5762882,141211627,0,300,2574,141214201
2017-11-01,11302588,144616346,1000,1300,11141,144627487
2017-11-02,11765187,148563681,63700,64000,537600,149101281
2017-11-03,8094609,144623632,0,300,2520,144626152
2017-11-06,6421911,145692312,0,300,2508,145694820
2017-11-07,8609428,151244377,3000,3300,27753,151272130
2017-11-08,11359705,155029373,0,300,2529,155031902
2017-11-09,7512227,159783475,0,300,2532,159786007
2017-11-10,6192159,153293095,0,300,2538,153295633
2017-11-13,7535469,156247066,2000,2300,19596,156266662
2017-11-14,9989062,161636035,0,300,2529,161638564
2017-11-15,5600443,161611217,0,300,2520,161613737
2017-11-16,7766262,160090028,2000,2300,19320,160109348
2017-11-17,9115719,154699828,1000,1000,8140,154707968
2017-11-20,11730839,160626878,49900,49900,404689,161031567
2017-11-21,6605776,160227711,0,49900,402693,160630404
2017-11-22,8079211,160586860,100,44500,361785,160948645
2017-11-23,8964224,161710069,14600,59000,466690,162176759
2017-11-24,11368608,159659661,2000,47000,382110,160041771
2017-11-27,8487886,162106586,30000,76000,607240,162713826
2017-11-28,3486478,157974591,0,45000,361350,158335941
2017-11-29,5987987,159277701,0,45000,364050,159641751
2017-11-30,4684142,158179253,0,44800,361088,158540341
2017-12-01,1852732,153054381,0,44800,361984,153416365
2017-12-04,5219403,156554321,0,44800,358400,156912721
2017-12-05,6422182,157066977,11900,56700,446229,157513206
2017-12-06,5763683,156284119,8300,53100,417897,156702016
2017-12-07,1449549,155710211,0,44800,350336,156060547
2017-12-08,1525608,152218282,0,44800,353920,152572202
2017-12-11,2508852,150207746,0,44800,357952,150565698
2017-12-12,4155402,149479191,0,44800,356160,149835351
2017-12-13,1814910,150056378,0,44800,357952,150414330
2017-12-14,3018742,150288992,0,44800,357952,150646944
2017-12-15,771335,147784577,0,44800,355264,148139841
2017-12-18,4302225,149297282,500,45300,354699,149651981
2017-12-19,2881758,147963761,500,45800,364568,148328329
2017-12-20,2045855,144440696,47527,92827,725907,145166603
2017-12-21,2386008,144428179,0,45300,357417,144785596
2017-12-22,1864397,142772045,0,44800,355712,143127757
2017-12-25,3101377,143371383,0,44800,353920,143725303
2017-12-26,2882104,142179889,1000,45800,366858,142546747
2017-12-27,8053168,147176523,17000,62800,501144,147677667
2017-12-28,5973454,145927654,0,62800,506796,146434450
2017-12-29,7971306,147830956,0,45800,371438,148202394
2018-01-02,8742231,149895984,3400,49200,400488,150296472
2018-01-03,9355257,148680130,69300,115100,934612,149614742
2018-01-04,4049535,146635677,0,45800,371438,147007115
2018-01-05,5449973,146308393,3400,49200,399996,146708389
2018-01-08,12578853,146711599,0,49200,404424,147116023
2018-01-09,4298403,142871515,2400,51600,424152,143295667
2018-01-10,6098348,145333234,7100,57700,470255,145803489
2018-01-11,6133935,147399088,6200,52000,423800,147822888
2018-01-12,4431778,147006712,0,46000,374440,147381152
2018-01-15,8630463,151831425,7300,52300,414216,152245641
2018-01-16,9303609,158085701,1000,52500,415275,158500976
2018-01-17,4213597,157772203,2000,54500,436545,158208748
2018-01-18,5290872,158839911,0,54500,440905,159280816
2018-01-19,6273423,156775775,0,48500,396730,157172505
2018-01-22,2762781,153227013,0,48500,398670,153625683
2018-01-23,6327189,154104831,1000,49500,406890,154511721
2018-01-24,3999011,154276524,0,49500,407880,154684404
2018-01-25,5439958,152969401,0,49500,406395,153375796
2018-01-26,5061017,152357788,0,48500,397215,152755003
2018-01-29,3219166,149022112,0,48500,397700,149419812
2018-01-30,3647790,149650493,0,47000,383050,150033543
2018-01-31,5087756,148558510,0,47000,377880,148936390
2018-02-01,3308972,143680707,11000,56500,440135,144120842
2018-02-02,6101644,132236789,0,55500,424575,132661364
2018-02-05,5489724,130863545,0,55500,421800,131285345
2018-02-06,5924941,131703654,0,45500,329875,132033529
2018-02-07,5530595,130639276,2200,47700,352503,130991779
2018-02-08,2235504,130412516,0,47700,355365,130767881
2018-02-09,5102755,126563811,3900,51600,367908,126931719
2018-02-12,2576669,123821474,0,51500,374920,124196394
2018-02-13,2695661,123557807,0,47700,347256,123905063
2018-02-14,784801,121810915,0,45500,332150,122143065
2018-02-22,1266523,121099701,0,45500,336700,121436401
2018-02-23,1764982,121158114,0,45500,336700,121494814
2018-02-26,4596357,122677841,0,45500,342160,123020001
2018-02-27,3526679,123612592,0,45500,338065,123950657
2018-02-28,4640821,125326462,0,45500,338975,125665437
2018-03-01,2684495,124024596,1000,46500,352935,124377531
2018-03-02,4367095,121838645,0,46500,351540,122190185
2018-03-05,2148187,121165422,12800,59300,449494,121614916
2018-03-06,3604128,122018602,1000,16100,123004,122141606
2018-03-07,2431725,122511595,700,15800,119606,122631201
2018-03-08,4962645,126213146,0,3000,22800,126235946
2018-03-09,1300831,122917670,0,3000,23040,122940710
2018-03-12,5632251,119833804,10000,11700,90909,119924713
2018-03-13,4094927,117160513,0,1700,13141,117173654
2018-03-14,4551987,117810322,0,1700,12869,117823191
2018-03-15,1594530,117349689,0,1700,12869,117362558
2018-03-16,1593259,115466039,8000,9700,73332,115539371
2018-03-19,2782823,117235141,9100,18100,135388,117370529
2018-03-20,3468073,115248418,2000,2000,14820,115263238
2018-03-21,6315278,118859073,22000,23000,167440,119026513
2018-03-22,2937112,118901600,3000,5000,36050,118937650
2018-03-23,6469336,118432754,600,2600,17888,118450642
2018-03-26,2503399,116707825,23500,23500,163795,116871620
2018-03-27,3218613,117924291,1500,25000,176500,118100791
2018-03-28,4867407,119661711,0,25000,173000,119834711
2018-03-29,5360446,120588659,74700,99700,712855,121301514
2018-03-30,1715370,117167887,300,100000,715000,117882887
2018-04-02,5510096,120244101,0,100000,708000,120952101
2018-04-03,2163270,119284689,0,96500,673570,119958259
2018-04-04,2612428,118376804,2100,97600,685152,119061956
2018-04-09,1760966,116621892,0,96600,678132,117300024
2018-04-10,2476331,115984279,1000,70008,496357,116480636
2018-04-11,6357002,118463178,0,70008,503358,118966536
2018-04-12,3183841,118782933,34900,101208,715541,119498474
2018-04-13,1336339,117195471,1000,102208,725677,117921148
2018-04-16,2738291,115853581,2700,3400,23834,115877415
2018-04-17,1089127,114265152,0,700,4900,114270052
2018-04-18,2456619,113782398,22600,23300,165663,113948061
2018-04-19,2463412,115344970,0,23300,164964,115509934
2018-04-20,3418045,114270204,1500,2200,15378,114285582
2018-04-23,4153481,116406536,1000,1700,11662,116418198
2018-04-24,3336324,115569199,0,1700,11968,115581167
2018-04-25,2638231,115660508,0,1700,11917,115672425
2018-04-26,8794391,116354245,17500,18200,129948,116484193
2018-04-27,3907475,115825424,0,1500,10770,115836194
2018-05-02,4412141,116303596,1500,2000,14380,116317976
2018-05-03,5091355,118083000,1000,2500,18150,118101150
2018-05-04,4289419,117528471,0,1500,10725,117539196
2018-05-07,6736512,121193475,1000,2500,18050,121211525
2018-05-08,4487516,119239469,0,1000,7250,119246719
2018-05-09,3086094,119508549,30000,31000,224440,119732989
2018-05-10,2845652,118702075,1000,32000,232640,118934715
2018-05-11,4547784,116899971,0,2000,14640,116914611
2018-05-14,4803298,120172643,0,2000,14540,120187183
2018-05-15,2459775,119180549,1000,3000,21840,119202389
2018-05-16,2297936,118607255,0,3000,21810,118629065
2018-05-17,1991669,119627091,0,3000,21750,119648841
2018-05-18,2283310,119002649,0,3000,21900,119024549
2018-05-21,11169630,125474219,0,3000,22200,125496419
2018-05-22,2856944,124466859,0,3000,22230,124489089
2018-05-23,5032134,124380640,0,2000,14600,124395240
2018-05-24,2674606,123150591,1000,2000,14760,123165351
2018-05-25,2921084,123591851,0,1000,7300,123599151
2018-05-28,2711391,123660591,0,1000,7230,123667821
2018-05-29,2847153,123696022,0,1000,7180,123703202
2018-05-30,1892220,123817054,7000,7000,48720,123865774
2018-05-31,2422788,124883848,0,7000,49350,124933198
2018-06-01,2314307,124850198,10000,17000,118830,124969028
2018-06-04,2280440,125471734,0,17000,119340,125591074
2018-06-05,2243588,126296191,0,17000,119680,126415871
2018-06-06,2539891,127260740,0,17000,118660,127379400
2018-06-07,2274232,128289515,0,10000,69900,128359415
2018-06-08,3108097,128199077,0,10000,70800,128269877
2018-06-11,2470381,124358212,1600,11600,81780,124439992
2018-06-12,1484249,122675501,0,11600,82708,122758209
2018-06-13,1235408,120125667,0,11600,82592,120208259
2018-06-14,1648597,119628352,10000,21600,155304,119783656
2018-06-15,1676652,114030690,17300,23900,173036,114203726
2018-06-19,4974174,114088335,13000,36900,256086,114344421
2018-06-20,1841041,112916929,21100,58000,415860,113332789
2018-06-21,2961917,110219685,2000,60000,437400,110657085
2018-06-22,8660727,114409388,5500,50500,378245,114787633
2018-06-25,3228416,113904167,21600,59500,443870,114348037
2018-06-26,3522139,112576319,700,33900,253233,112829552
2018-06-27,4551605,113870433,18900,51500,383675,114254108
2018-06-28,1551361,112515203,52500,100200,740478,113255681
2018-06-29,5937288,112509702,800,60500,448910,112958612
2018-07-02,3622680,110508952,41800,86600,634778,111143730
2018-07-03,7002096,112289556,18300,50000,374500,112664056
2018-07-04,3951540,111587509,28500,78500,587965,112175474
2018-07-05,3063451,111237792,3500,67500,497475,111735267
2018-07-06,3071294,112009897,18300,54500,396215,112406112
2018-07-09,3245525,113131481,12000,50100,369738,113501219
2018-07-10,3995172,116043190,3400,43500,319290,116362480
2018-07-11,4170548,116788304,55500,86400,613440,117401744
2018-07-12,2593822,116950578,12600,99000,719730,117670308
2018-07-13,4698774,118242368,2200,93900,692043,118934411
2018-07-16,6393284,121534248,11100,102300,759066,122293314
2018-07-17,4995346,122361196,2700,105000,779100,123140296
2018-07-18,4813755,118154304,0,105000,783300,118937604
2018-07-19,3838789,116867688,0,105000,787500,117655188
2018-07-20,5167626,113883211,0,49500,371250,114254461
2018-07-23,6509163,114070950,15600,63400,482474,114553424
2018-07-24,7487500,111404025,900,49700,380702,111784727
2018-07-25,5321010,109649782,5000,42500,320875,109970657
2018-07-26,2274748,109536640,0,47300,243595,109780235
2018-07-27,1999907,109836732,0,47300,242649,110079381
2018-07-30,2213923,109813739,0,46060,231221,110044960
2018-07-31,1820828,110145965,0,46060,233524,110379489
2018-08-01,2704933,106798649,0,43260,211109,107009758
2018-08-02,2717503,107609604,171700,200820,965944,108575548
2018-08-03,1046254,107918782,0,200820,963936,108882718
2018-08-06,1612986,108428199,0,29120,139776,108567975
2018-08-07,1589416,108195165,0,0,0,108195165
2018-08-08,831995,108027979,15000,15000,71850,108099829
2018-08-09,1527752,107936910,0,15000,72150,108009060
2018-08-10,646350,107732704,0,15000,72000,107804704
2018-08-13,1765476,108452330,200000,215000,1019100,109471430
2018-08-14,2046515,109336935,0,215000,1021250,110358185
2018-08-15,1100248,108888613,0,215000,1019100,109907713
2018-08-16,1467807,108598288,0,120000,561600,109159888
2018-08-17,1595660,108197229,49400,169400,767382,108964611
2018-08-20,1787550,109010952,4000,145300,642226,109653178
2018-08-21,932390,109001533,2700,97940,433874,109435407
2018-08-22,178081,108225867,0,97940,429957,108655824
2018-08-23,156487,107878303,0,97940,429957,108308260
2018-08-24,332954,106856199,100,64340,282453,107138652
2018-08-27,1108912,107228683,0,4400,19492,107248175
2018-08-28,1506711,107983877,0,4400,19536,108003413
2018-08-29,1477133,107788868,0,4400,19756,107808624
2018-08-30,1852806,108193321,200,4600,20194,108213515
2018-08-31,977056,106602220,900,900,3834,106606054
2018-09-03,1449454,105565175,700,700,2996,105568171
2018-09-04,1128705,104919711,500,500,2145,104921856
2018-09-05,658314,104939977,60100,60600,254520,105194497
2018-09-06,575811,104605589,0,0,0,104605589
2018-09-07,469881,104297476,0,0,0,104297476
2018-09-10,1383777,103284812,3000,3000,12330,103297142
2018-09-11,392693,101734550,0,3000,12330,101746880
2018-09-12,91155,101006172,0,3000,12360,101018532
2018-09-13,1125293,101302981,0,3000,12420,101315401
2018-09-14,798687,101187410,0,3000,12420,101199830
2018-09-17,455762,100690459,0,3000,12570,100703029
2018-09-18,2820150,101630746,0,3000,12480,101643226
2018-09-19,7064898,106699067,0,3000,12600,106711667
2018-09-20,1215113,103085567,0,3000,12420,103097987
2018-09-21,8457116,105714505,175800,178800,756324,106470829
2018-09-25,1331679,105276372,0,3000,12570,105288942
2018-09-26,2600572,102599432,12200,15200,64752,102664184
2018-09-27,2338462,102946665,0,3000,12480,102959145
2018-09-28,506720,98833141,0,3000,12720,98845861
2018-10-08,1965367,99957852,7500,10500,43575,100001427
2018-10-09,764645,99851033,0,3000,12450,99863483
2018-10-10,1238937,100622071,8800,11800,49088,100671159
2018-10-11,2227570,95106509,3440,15240,57455,95163964
2018-10-12,914818,94193851,9660,12660,46589,94240440
2018-10-15,710009,94083705,5500,18160,64650,94148355
2018-10-16,793979,93131535,29800,42460,144789,93276324
2018-10-17,2091890,94033852,43600,86060,296046,94329898
2018-10-18,231092,92756741,10000,24900,85158,92841899
2018-10-19,602538,92173513,0,5500,19360,92192873
2018-10-22,3842237,93347072,0,5500,20515,93367587
2018-10-23,1256187,92917734,16040,21540,77975,92995709
2018-10-24,953669,92761961,0,5500,19965,92781926
2018-10-25,5312483,91737775,209438,214938,842557,92580332
2018-10-26,6491644,94856900,0,5500,21010,94877910
2018-10-29,1288029,92088682,22400,27900,101556,92190238
2018-10-30,1905639,93181145,0,5500,20185,93201330
2018-10-31,4605369,92016149,31300,36800,138736,92154885
2018-11-01,3719485,93135215,0,18500,69745,93204960
2018-11-02,2422830,92268541,0,5500,21285,92289826
2018-11-05,3537958,93133312,2000,7500,28875,93162187
2018-11-06,1896266,93349864,143400,148900,573265,93923129
2018-11-07,2428519,93417138,0,5500,21175,93438313
2018-11-08,2369358,94757869,33000,38500,148995,94906864
2018-11-09,1832519,94271559,8400,43900,168576,94440135
2018-11-12,6535057,96740632,0,32500,127400,96868032
2018-11-13,6152516,98163455,0,32500,129675,98293130
2018-11-14,10304087,99408417,174200,186700,752401,100160818
2018-11-15,5049104,99273112,28300,30800,125356,99398468
2018-11-16,7834067,97750311,61000,91800,380970,98131281
2018-11-19,7973333,102072500,17000,78800,329384,102401884
2018-11-20,3400446,98167787,36200,39800,161588,98329375
2018-11-21,2030461,97343116,1000,4500,18315,97361431
2018-11-22,3614039,99575737,73900,76400,317060,99892797
2018-11-23,2406101,98002918,10000,12500,48750,98051668
2018-11-26,2407454,99048131,51200,56200,218618,99266749
2018-11-27,879754,98106094,5000,50300,197679,98303773
2018-11-28,2294731,98257516,11900,62100,242811,98500327
2018-11-29,2676082,99103279,32900,78800,299440,99402719
2018-11-30,2631416,98736105,0,40200,152760,98888865
2018-12-03,3575215,98877268,37400,75100,298898,99176166
2018-12-04,2123412,97184612,7400,82500,335775,97520387
2018-12-05,6783640,97175780,32500,107600,446540,97622320
2018-12-06,4651168,97821353,3400,85200,345060,98166413
2018-12-07,3372459,99055167,0,81800,331290,99386457
2018-12-10,1583147,99806679,16400,98200,391818,100198497
2018-12-11,1916350,100645292,0,75100,301902,100947194
2018-12-12,3850611,99016469,16400,91500,371490,99387959
2018-12-13,2547450,96642880,23500,108600,440916,97083796
2018-12-14,2702452,96460541,500,38200,149744,96610285
2018-12-17,3022983,96943415,76800,115000,462300,97405715
2018-12-18,2201422,95937606,0,37700,147784,96085390
2018-12-19,1383843,95536757,72100,109800,419436,95956193
2018-12-20,1584825,96269741,5200,115000,438150,96707891
2018-12-21,607564,96339981,0,109800,413946,96753927
2018-12-24,584541,95986482,0,109800,423828,96410310
2018-12-25,1415970,94874252,3600,113400,422982,95297234
2018-12-26,1941580,95822887,1600,86200,323250,96146137
2018-12-27,1486189,95659924,13100,99300,372375,96032299
2018-12-28,701057,94630613,0,81000,300510,94931123
2019-01-02,612470,94686981,0,81000,298890,94985871
2019-01-03,1514561,95858764,0,81000,298080,96156844
2019-01-04,3628452,95888601,23600,32500,124475,96013076
2019-01-07,1990124,96281318,73600,106100,414851,96696169
2019-01-08,731987,94013567,8400,82900,328284,94341851
2019-01-09,4678258,94023765,32100,82200,329622,94353387
2019-01-10,4061407,95461485,27800,90700,360079,95821564
2019-01-11,781680,93228957,18300,100100,403403,93632360
2019-01-14,288461,92633212,0,100100,401401,93034613
2019-01-15,1930076,92200525,0,95700,385671,92586196
2019-01-16,878033,92082005,0,95700,386628,92468633
2019-01-17,4574504,95451726,0,80300,317185,95768911
2019-01-18,756711,93693228,0,80300,323609,94016837
2019-01-21,2140835,93235007,0,69100,276400,93511407
2019-01-22,525707,90966725,0,40200,159192,91125917
2019-01-23,962382,89773817,0,40200,161604,89935421
2019-01-24,1213480,90207020,0,40200,160800,90367820
2019-01-25,1294359,89854940,0,40200,160398,90015338
2019-01-28,1871073,90532737,0,20200,78376,90611113
2019-01-29,1406246,89332111,0,200,784,89332895
2019-01-30,835922,89308126,0,200,778,89308904
2019-01-31,1978295,87315010,0,200,760,87315770
2019-02-01,1545312,85250691,0,200,790,85251481
2019-02-11,3713353,87267913,0,200,804,87268717
2019-02-12,4349149,87300753,0,200,810,87301563
2019-02-13,2784265,86351201,0,200,824,86352025
2019-02-14,5159659,90239861,0,200,826,90240687
2019-02-15,3299280,91686715,0,200,812,91687527
2019-02-18,13392194,97313942,0,200,894,97314836
2019-02-19,21120142,92474645,0,200,908,92475553
2019-02-20,24433222,102426109,0,200,922,102427031
2019-02-21,12142132,105109343,0,200,922,105110265
2019-02-22,16695391,110667751,0,200,918,110668669
2019-02-25,21629177,111828576,0,200,950,111829526
2019-02-26,16984489,112315398,0,200,922,112316320
2019-02-27,13564726,114738801,0,200,916,114739717
2019-02-28,6259453,116470021,0,200,924,116470945
2019-03-01,3788330,113790934,0,200,936,113791870
2019-03-04,16438964,119572321,0,200,940,119573261
2019-03-05,18067889,128123519,0,200,958,128124477
2019-03-06,18711299,130541096,0,200,978,130542074
2019-03-07,12532989,128027429,0,200,982,128028411
2019-03-08,15830727,129373550,0,200,932,129374482
2019-03-11,18578422,128712104,0,200,994,128713098
2019-03-12,21660484,134299149,0,200,1000,134300149
2019-03-13,12070853,128882027,0,200,992,128883019
2019-03-14,8024698,110624167,0,200,966,110625133
2019-03-15,2451925,106607386,0,200,982,106608368
2019-03-18,7962286,104529725,0,200,1016,104530741
2019-03-19,6965452,98676753,0,200,1026,98677779
2019-03-20,7488122,99263242,0,200,1018,99264260
2019-03-21,6011046,97316714,0,200,1024,97317738
2019-03-22,10411706,101937374,0,200,1052,101938426
2019-03-25,20168115,112594484,0,200,1056,112595540
2019-03-26,6000822,108162170,0,200,1022,108163192
2019-03-27,4775166,107375162,7800,8000,41760,107416922
2019-03-28,3137228,103749797,0,8000,40960,103790757
2019-03-29,6536087,97722066,0,200,1036,97723102
2019-04-01,16388760,104751161,0,200,1070,104752231
2019-04-02,14815063,112826632,0,200,1070,112827702
2019-04-03,14079811,117920640,0,200,1078,117921718
2019-04-04,8058752,113172401,100,300,1614,113174015
2019-04-08,12076430,114054564,0,300,1590,114056154
2019-04-09,17063974,118879090,0,300,1599,118880689
2019-04-10,18227929,121693641,0,300,1647,121695288
2019-04-11,25547825,125072712,7700,8000,43600,125116312
2019-04-12,46124736,140251895,0,300,1764,140253659
2019-04-15,23223581,126613586,0,300,1752,126615338
2019-04-16,20426351,127954537,7700,8000,46320,128000857
2019-04-17,22437702,126863283,0,8000,48160,126911443
2019-04-18,29395955,129746357,0,8000,46400,129792757
2019-04-19,15136830,130743966,0,8000,45920,130789886
2019-04-22,23951408,144072509,0,300,1650,144074159
2019-04-23,15899335,150581304,0,300,1581,150582885
2019-04-24,6824637,146763499,0,300,1587,146765086
2019-04-25,15308400,148555032,0,200,994,148556026
2019-04-26,4716832,145568275,0,200,1002,145569277
2019-04-29,6968621,144469250,0,200,980,144470230
2019-04-30,4519520,135154862,7800,8000,41440,135196302
2019-05-06,11362858,132634349,0,200,1052,132635401
2019-05-07,8039697,134651202,2000,2200,11616,134662818
2019-05-08,6012221,132052848,0,200,1014,132053862
2019-05-09,3100793,131890835,1900,2100,10731,131901566
2019-05-10,6166930,132483417,0,2100,10857,132494274
2019-05-13,6244141,134550694,7800,9900,51381,134602075
2019-05-14,6197544,135534967,0,9900,49995,135584962
2019-05-15,3871332,137586668,0,9900,50589,137637257
2019-05-16,2196171,136634128,100,10000,51100,136685228
2019-05-17,3480142,137076546,0,10000,50300,137126846
2019-05-20,1811225,132605052,0,10000,50500,132655552
2019-05-21,2719294,134093044,0,10000,51600,134144644
2019-05-22,1486747,131422664,0,10000,51300,131473964
2019-05-23,2464817,129357303,0,10000,49500,129406803
2019-05-24,3868669,128237152,0,9800,48314,128285466
2019-05-27,7152658,131167250,200,10000,49900,131217150
2019-05-28,1568008,129462686,0,10000,49800,129512486
2019-05-29,1877527,129002506,0,10000,49800,129052306
2019-05-30,6191173,133725947,0,10000,49600,133775547
2019-05-31,3266236,130473800,0,2200,10846,130484646
2019-06-03,1808884,131817569,0,2200,10692,131828261
2019-06-04,923360,130433863,0,2200,10604,130444467
2019-06-05,208673,129315108,0,2200,10604,129325712
2019-06-06,1429840,128593101,0,2000,9420,128602521
2019-06-10,847311,129024483,0,2000,9440,129033923
2019-06-11,1387220,128368068,200,200,968,128369036
2019-06-12,508063,125858677,0,0,0,125858677
2019-06-13,1541806,126601262,0,0,0,126601262
2019-06-14,1060009,126728824,0,0,0,126728824
2019-06-17,472358,126625348,7800,7800,37284,126662632
2019-06-18,894176,126684341,0,0,0,126684341
2019-06-19,754754,126508870,0,0,0,126508870
2019-06-20,1118883,121505862,0,0,0,121505862
2019-06-21,1498981,119017234,0,0,0,119017234
2019-06-24,1457435,118561103,0,0,0,118561103
2019-06-25,2573789,118681024,3000,3000,14760,118695784
2019-06-26,129479,118255029,0,3000,14280,118269309
2019-06-27,443390,117812021,0,3000,14340,117826361
2019-06-28,1559975,115067385,0,3000,14010,115081395
2019-07-01,2646927,115810319,0,3000,14220,115824539
2019-07-02,500975,114223309,0,3000,14280,114237589
2019-07-03,670772,113074835,0,3000,14130,113088965
2019-07-04,736471,113351382,0,3000,14190,113365572
2019-07-05,873559,112095426,0,3000,14160,112109586
2019-07-08,1638654,112947911,0,3000,13620,112961531
2019-07-09,1486397,113033628,0,3000,13530,113047158
2019-07-10,1856432,113540154,0,3000,13290,113553444
2019-07-11,391151,112600971,4800,7800,34398,112635369
2019-07-12,561950,111143401,0,7800,34398,111177799
2019-07-15,865344,110959979,100,4900,21805,110981784
2019-07-16,330045,109794894,0,100,455,109795349
2019-07-17,104796,109468043,3000,3100,14043,109482086
2019-07-18,164226,109202332,0,3100,13795,109216127
2019-07-19,1454350,110105619,0,3000,13440,110119059
2019-07-22,417173,110112579,2200,5200,22932,110135511
2019-07-23,113838,109698616,0,3000,13350,109711966
2019-07-24,437305,109706608,4800,4800,21744,109728352
2019-07-25,394642,108156720,0,0,0,108156720
2019-07-26,127178,107905473,0,0,0,107905473
2019-07-29,1335905,106923502,7800,7800,36348,106959850
2019-07-30,200243,106337366,0,0,0,106337366
2019-07-31,405729,105984429,0,0,0,105984429
2019-08-01,159038,105482055,0,0,0,105482055
2019-08-02,220294,105129114,2200,2200,10208,105139322
2019-08-05,203487,105037072,200,2400,10968,105048040
2019-08-06,89700,103580891,0,2400,10848,103591739
2019-08-07,562475,104057947,0,2400,10824,104068771
2019-08-08,422684,104410540,0,2400,10824,104421364
2019-08-09,454678,104198791,0,2400,10800,104209591
2019-08-12,277480,103894397,0,2400,11016,103905413
2019-08-13,591465,104164030,0,2400,10920,104174950
2019-08-14,156997,104086546,2500,2700,12366,104098912
2019-08-15,1036215,104617761,5300,5500,25465,104643226
2019-08-16,1144356,105331602,0,200,906,105332508
2019-08-19,842000,105281710,0,200,920,105282630
2019-08-20,1420041,105969093,0,200,900,105969993
2019-08-21,717083,105956658,0,200,906,105957564
2019-08-22,2394309,103560886,0,200,888,103561774
2019-08-23,201531,103267608,1000,1200,5316,103272924
2019-08-26,1125470,102573981,6800,7000,31220,102605201
2019-08-27,1015428,101197767,0,7000,32410,101230177
2019-08-28,1024727,100459000,0,7000,32550,100491550
2019-08-29,991120,100839564,0,200,916,100840480
2019-08-30,795345,101173532,0,200,906,101174438
2019-09-02,455405,99719409,0,200,926,99720335
2019-09-03,560110,99459944,0,200,920,99460864
2019-09-04,513819,98599413,0,200,922,98600335
2019-09-05,3483227,100569384,0,200,932,100570316
2019-09-06,2443747,100918691,0,200,942,100919633
2019-09-09,879164,100673496,0,200,952,100674448
2019-09-10,1554810,101391950,0,200,952,101392902
2019-09-11,1246111,100876333,0,200,938,100877271
2019-09-12,1642248,101280525,0,200,942,101281467
2019-09-16,608801,100277344,0,200,952,100278296
2019-09-17,5369026,99884142,0,200,966,99885108
2019-09-18,1074841,96235609,0,200,960,96236569
2019-09-19,2198996,95428115,0,200,980,95429095
2019-09-20,3904214,97490743,0,200,974,97491717
2019-09-23,3614056,99728063,0,200,966,99729029
2019-09-24,3172591,102031566,0,200,964,102032530
2019-09-25,758617,99469498,0,200,960,99470458
2019-09-26,4592064,101185424,0,200,946,101186370
2019-09-27,2588822,103207112,0,200,938,103208050
2019-09-30,1875654,103492610,0,200,938,103493548
2019-10-08,3397111,105418719,0,200,918,105419637
2019-10-09,2662666,106432824,0,200,936,106433760
2019-10-10,3806202,107294734,0,200,936,107295670
2019-10-11,1977352,107964122,0,200,944,107965066
2019-10-14,2264901,106683644,0,200,962,106684606
2019-10-15,795731,106644633,0,200,956,106645589
2019-10-16,694601,104905799,0,200,940,104906739
2019-10-17,399380,104501856,0,200,934,104502790
2019-10-18,1602413,99539566,0,200,904,99540470
2019-10-21,532453,97801753,7800,8000,35760,97837513
2019-10-22,141680,97240993,0,8000,36000,97276993
2019-10-23,273331,97253448,0,8000,35760,97289208
2019-10-24,3996,96958735,0,8000,35840,96994575
2019-10-25,1453460,98154677,0,200,904,98155581
2019-10-28,899558,98105428,0,200,916,98106344
2019-10-29,175540,98050414,0,200,904,98051318
2019-10-30,2658931,100039454,0,200,902,100040356
2019-10-31,4246317,103204796,0,200,908,103205704
2019-11-01,3473309,103548771,0,200,914,103549685
2019-11-04,234473,100311891,0,200,918,100312809
2019-11-05,1686527,99501000,7800,8000,36320,99537320
2019-11-06,2495339,101221348,0,200,900,101222248
2019-11-07,291219,100777531,0,200,908,100778439
2019-11-08,1207025,100559993,0,200,900,100560893
2019-11-11,1055858,100397850,2500,2700,12015,100409865
2019-11-12,255355,99871587,0,2700,12123,99883710
2019-11-13,190807,99115877,0,2700,12231,99128108
2019-11-14,311917,98670606,0,2700,12285,98682891
2019-11-15,741610,98018239,0,2700,12258,98030497
2019-11-18,734097,98057470,0,2700,12339,98069809
2019-11-19,2026424,97460911,0,2700,12285,97473196
2019-11-20,1047767,97627278,0,2700,12150,97639428
2019-11-21,956781,98458989,0,2700,12042,98471031
2019-11-22,2438817,100266381,0,2700,12069,100278450
2019-11-25,556196,100567031,0,2700,12150,100579181
2019-11-26,1067065,100666563,0,2700,12231,100678794
2019-11-27,1214854,100607420,0,2700,12285,100619705
2019-11-28,1445828,99395199,0,2700,12474,99407673
2019-11-29,358058,98821590,0,2700,12474,98834064
2019-12-02,1316423,99041005,0,200,924,99041929
2019-12-03,741833,99144453,900,1100,5093,99149546
2019-12-04,765137,99368874,0,1100,5060,99373934
2019-12-05,4446699,102637108,0,1100,5049,102642157
2019-12-06,301425,99801568,0,1100,5060,99806628
2019-12-09,530865,98998628,0,1100,5115,99003743
2019-12-10,1309659,99062421,0,1100,5082,99067503
2019-12-11,2594940,99755034,0,1100,5115,99760149
2019-12-12,2076613,94876889,0,1100,5170,94882059
2019-12-13,3463118,95936177,0,1100,5170,95941347
2019-12-16,2319747,96563704,6900,8000,37840,96601544
2019-12-17,2350160,96622100,0,1100,5225,96627325
2019-12-18,2526861,96114809,0,1100,5181,96119990
2019-12-19,1396007,96384023,0,1100,5192,96389215
2019-12-20,1587171,96255465,0,1100,5126,96260591
2019-12-23,7634753,99025834,0,1100,5214,99031048
2019-12-24,2950698,99956587,0,1100,5280,99961867
2019-12-25,4158558,96807882,0,1100,5203,96813085
2019-12-26,2964820,97202596,0,1100,5214,97207810
2019-12-27,3544322,97335049,0,1100,5181,97340230
2019-12-30,4159363,97649211,0,1100,5181,97654392
2019-12-31,1114527,96796911,0,1100,5236,96802147
2020-01-02,1777790,97440169,0,1100,5313,97445482
2020-01-03,3814392,99489876,0,1100,5302,99495178
2020-01-06,4712878,98280915,0,1100,5368,98286283
2020-01-07,14181337,104658809,0,1100,5489,104664298
2020-01-08,19042299,107198024,6900,8000,40800,107238824
2020-01-09,13563190,108581046,0,1100,5665,108586711
2020-01-10,13427376,113383998,2400,3500,17500,113401498
2020-01-13,10276473,117593699,0,1100,5555,117599254
2020-01-14,11168621,118955994,0,1100,5489,118961483
2020-01-15,5393278,119767949,0,1100,5434,119773383
2020-01-16,4394091,120262613,0,1100,5445,120268058
2020-01-17,4176683,120985757,0,1100,5390,120991147
2020-01-20,4046704,121680741,0,1100,5434,121686175
2020-01-21,4746060,121505858,0,1100,5291,121511149
2020-01-22,4367799,119373697,0,200,968,119374665
2020-01-23,3366134,114955667,0,200,934,114956601
2020-02-03,2217920,112624617,0,0,0,112624617
2020-02-04,4571307,108998596,0,0,0,108998596
2020-02-05,5089134,109596918,0,0,0,109596918
2020-02-06,7739122,104942123,0,0,0,104942123
2020-02-07,2880146,100091150,0,0,0,100091150
2020-02-10,4848652,101283726,200,200,886,101284612
2020-02-11,11810386,105909646,0,200,892,105910538
2020-02-12,5339221,102714444,0,200,898,102715342
2020-02-13,5235827,97936173,0,200,870,97937043
2020-02-14,1440128,93941825,0,200,874,93942699
2020-02-17,9931514,99915521,0,200,902,99916423
2020-02-18,11776338,100029680,0,200,926,100030606
2020-02-19,3553952,97200954,0,200,920,97201874
2020-02-20,10912093,103534376,0,200,944,103535320
2020-02-21,7467969,103407961,0,200,954,103408915
2020-02-24,10577793,105208164,0,200,946,105209110
2020-02-25,4481605,104357128,0,200,928,104358056
2020-02-26,27703743,106849659,0,200,1020,106850679
2020-02-27,24605489,96620405,0,200,1060,96621465
2020-02-28,39159424,97579415,0,0,0,97579415
2020-03-02,23778257,113576036,200,200,1282,113577318
2020-03-03,80258741,114315436,0,200,1324,114316760
2020-03-04,72704692,139832452,0,200,1342,139833794
2020-03-05,55176654,133468506,0,200,1476,133469982
2020-03-06,47793941,120131394,0,200,1358,120132752
2020-03-09,43713185,133581785,0,200,1290,133583075
2020-03-10,36830570,126321993,0,200,1330,126323323
2020-03-11,17079106,112810422,0,200,1282,112811704
2020-03-12,28424059,115990595,0,200,1266,115991861
2020-03-13,11545613,106911819,0,200,1248,106913067
2020-03-16,16350851,108152002,0,200,1200,108153202
2020-03-17,21782526,113806577,0,0,0,113806577
2020-03-18,20012417,117386120,100,100,561,117386681
2020-03-19,12063100,111696304,0,0,0,111696304
2020-03-20,11643007,109862660,0,0,0,109862660
2020-03-23,14208470,113774168,0,0,0,113774168
2020-03-24,13274410,120586994,200,200,1036,120588030
2020-03-25,19693658,118661515,0,0,0,118661515
2020-03-26,12977742,120571814,0,0,0,120571814
2020-03-27,8436889,110804016,200,200,1040,110805056
2020-03-30,6437726,110957558,0,200,1020,110958578
2020-03-31,7355159,106675694,0,0,0,106675694
2020-04-01,8314290,101064510,0,0,0,101064510
2020-04-02,7795040,103495793,0,0,0,103495793
2020-04-03,6613499,101137741,0,0,0,101137741
2020-04-07,8602773,96520421,0,0,0,96520421
2020-04-08,10886984,92349981,0,0,0,92349981
2020-04-09,10170645,95273572,0,0,0,95273572
2020-04-10,11538621,97983774,5700,5700,29868,98013642
2020-04-13,10011701,101910665,0,0,0,101910665
2020-04-14,3169070,95472506,0,0,0,95472506
2020-04-15,13290229,101289690,0,0,0,101289690
2020-04-16,4408852,100166958,0,0,0,100166958
2020-04-17,6185085,89218739,7800,7800,39936,89258675
2020-04-20,2292363,86678443,0,0,0,86678443
2020-04-21,8858325,80805579,0,0,0,80805579
2020-04-22,4020924,82436033,0,0,0,82436033
2020-04-23,3850461,81052662,0,0,0,81052662
2020-04-24,6010347,83469729,0,0,0,83469729
2020-04-27,2976323,81291330,0,0,0,81291330
2020-04-28,4258828,78697126,0,0,0,78697126
2020-04-29,2901663,78823432,0,0,0,78823432
2020-04-30,4183180,78069271,0,0,0,78069271
2020-05-06,8569582,82388918,0,0,0,82388918
2020-05-07,5102402,82897785,0,0,0,82897785
2020-05-08,5573497,82834152,0,0,0,82834152
2020-05-11,10794635,82107452,0,0,0,82107452
2020-05-12,5239617,84417180,0,0,0,84417180
2020-05-13,3950374,81353950,900,900,4500,81358450
2020-05-14,4170997,84032547,0,900,4410,84036957
2020-05-15,3591189,84965124,0,900,4356,84969480
2020-05-18,8321248,88928219,0,0,0,88928219
2020-05-19,3749828,85307703,0,0,0,85307703
2020-05-20,7108913,87222904,0,0,0,87222904
2020-05-21,6568698,90665861,0,0,0,90665861
2020-05-22,7165476,90716018,7800,7800,35724,90751742
2020-05-25,1852655,90717709,0,7800,35802,90753511
2020-05-26,2640624,90248479,0,7800,36348,90284827
2020-05-27,12703184,94551111,0,7800,37596,94588707
2020-05-28,40502213,116110270,0,7800,39780,116150050
2020-05-29,35659231,98219100,0,7800,43758,98262858
2020-06-01,38039303,109720041,0,7800,48126,109768167
2020-06-02,31600823,118643325,25000,25000,169750,118813075
2020-06-03,56757116,128340087,7800,32800,214840,128554927
2020-06-04,50497744,129369979,0,32800,212872,129582851
2020-06-05,34335735,129124822,0,32800,195160,129319982
2020-06-08,21233378,120765133,0,30200,181502,120946635
2020-06-09,22047994,126919594,15000,40000,228400,127147994
2020-06-10,12973390,122058604,15000,55000,307450,122366054
2020-06-11,23727386,100341111,50900,105900,632223,100973334
2020-06-12,20579289,103560778,0,75000,441000,104001778
2020-06-15,15049374,104338190,900,50900,301837,104640027
2020-06-16,13743794,105227349,19100,70000,397600,105624949
2020-06-17,6316449,101339635,0,50000,277500,101617135
2020-06-18,26164964,96709055,97800,147800,903058,97612113
2020-06-19,34757530,104187437,0,66000,423060,104610497
2020-06-22,17079874,93103689,26800,92800,587424,93691113
2020-06-23,13178037,90780471,8600,61400,388048,91168519
2020-06-24,12586061,88495147,74059,128659,807979,89303126
2020-06-29,10880617,90896834,0,65000,399750,91296584
2020-06-30,12276274,89235781,48000,113000,722070,89957851
2020-07-01,12507278,90304680,20000,85000,524450,90829130
2020-07-02,14367444,86203096,0,65000,384800,86587896
2020-07-03,7429182,78384663,9300,59300,362323,78746986
2020-07-06,21599671,85503310,38500,82800,534060,86037370
2020-07-07,30606171,89365870,15000,57800,410380,89776250
2020-07-08,45990310,104892606,3000,38000,291840,105184446
2020-07-09,23167573,102650766,15000,50000,376000,103026766
2020-07-10,19216184,91933777,45900,80900,631020,92564797
2020-07-13,19556781,91324776,0,15000,128700,91453476
2020-07-14,17628607,81467597,25800,25800,218526,81686123
2020-07-15,17679173,87279620,0,18000,147420,87427040
2020-07-16,12845018,77936737,46700,64700,528599,78465336
2020-07-17,13916206,78573371,6100,42400,356160,78929531
2020-07-20,25234159,83982808,26700,67800,598674,84581482
2020-07-21,10168711,77654233,0,42800,377924,78032157
2020-07-22,13406173,71911004,11300,54100,469588,72380592
2020-07-23,10832600,71606371,21300,74100,614289,72220660
2020-07-24,6786429,69542272,1700,46700,367529,69909801
2020-07-27,5113645,65208591,0,46700,375001,65583592
2020-07-28,6370448,68169109,0,46700,367062,68536171
2020-07-29,5721625,68857173,0,46700,375935,69233108
2020-07-30,9295066,73728282,0,46700,358656,74086938
2020-07-31,5740351,76164797,0,46700,360057,76524854
2020-08-03,6994034,73049838,0,20000,159800,73209638
2020-08-04,5771377,73531153,0,20000,157600,73688753
2020-08-05,4679016,69206310,1500,21500,169850,69376160
2020-08-06,6334656,70395811,6300,26300,207244,70603055
2020-08-07,18493539,71696827,4100,24100,204850,71901677
2020-08-10,12109128,76246353,5900,27000,227610,76473963
2020-08-11,11049551,71911924,0,21100,172387,72084311
2020-08-12,11446211,74492600,6700,26700,212265,74704865
2020-08-13,8527341,72252140,1100,21100,176607,72428747
2020-08-14,5322172,70061491,1100,21600,183600,70245091
2020-08-17,11452394,71400903,0,20500,180605,71581508
2020-08-18,11558162,72531336,4000,24500,216580,72747916
2020-08-19,4998357,67332020,1300,24800,207328,67539348
2020-08-20,4145786,66230351,0,23500,189175,66419526
2020-08-21,3760555,65904431,0,23500,191995,66096426
2020-08-24,5129193,68691892,0,13500,109080,68800972
2020-08-25,7375835,71978413,0,13500,105300,72083713
2020-08-26,10131709,75215516,7300,20800,152672,75368188
2020-08-27,8802509,79128638,6500,19500,140595,79269233
2020-08-28,7192030,79737396,3500,23000,167440,79904836
2020-08-31,13317662,89068100,100,20100,141504,89209604
2020-09-01,8406102,92611897,0,20100,142911,92754808
2020-09-02,7741903,94167578,0,20000,139600,94307178
2020-09-03,6964565,95348194,10800,30800,210672,95558866
2020-09-04,2973903,89938822,0,23000,156630,90095452
2020-09-07,3465904,91208774,0,23000,154560,91363334
2020-09-08,1864760,90261345,0,23000,156170,90417515
2020-09-09,4995097,93006850,0,23000,149730,93156580
2020-09-10,4154079,94305530,0,10600,67522,94373052
2020-09-11,1855674,93674452,0,10600,68794,93743246
2020-09-14,5368109,96816398,0,10600,68158,96884556
2020-09-15,3734922,97873577,5000,15600,99372,97972949
2020-09-16,4684918,99910763,0,15600,100776,100011539
2020-09-17,15510309,103397568,2800,13400,91388,103488956
2020-09-18,12502697,104190130,0,10600,73882,104264012
2020-09-21,4961294,99764295,10200,20800,144560,99908855
2020-09-22,5209527,99406795,0,13000,87100,99493895
2020-09-23,2583482,100433250,0,13000,87490,100520740
2020-09-24,1018168,98942475,7800,17800,116056,99058531
2020-09-25,3821907,99902054,0,17800,117836,100019890
2020-09-28,1874824,99210883,0,17800,118726,99329609
2020-09-29,4107213,98744730,0,17800,119260,98863990
2020-09-30,2812868,96704442,0,17800,119438,96823880
2020-10-09,4318891,95926884,0,17800,124244,96051128
2020-10-12,13765529,103666502,0,17800,126736,103793238
2020-10-13,13085491,111752058,3000,20800,146640,111898698
2020-10-14,7976124,112475232,0,20800,145808,112621040
2020-10-15,20242751,120283707,0,20800,149344,120433051
2020-10-16,13192718,130295533,0,20800,147888,130443421
2020-10-19,7588201,136016994,0,20800,143520,136160514
2020-10-20,5577630,136891529,0,20800,144976,137036505
2020-10-21,10505931,144880521,0,20800,144768,145025289
2020-10-22,13217655,151429857,0,20800,145184,151575041
2020-10-23,15045694,130353031,0,20800,146432,130499463
2020-10-26,11282197,125531737,0,20800,147680,125679417
2020-10-27,6748659,126232085,0,20800,142272,126374357
2020-10-28,6441629,124150175,0,20800,145600,124295775
2020-10-29,28241406,115244424,0,16900,129792,115374216
2020-10-30,31161268,112071128,0,16900,126750,112197878
2020-11-02,24417586,114904535,0,16900,129285,115033820
2020-11-03,22641386,120712391,0,16900,125398,120837789
2020-11-04,28195343,131068052,3900,16900,132327,131200379
2020-11-05,21986696,126453304,0,13000,101530,126554834
2020-11-06,31290803,125661247,0,13000,104910,125766157
2020-11-09,13956839,108305023,6000,19000,167010,108472033
2020-11-10,26254368,110780562,0,13000,116740,110897302
2020-11-11,9748356,98544372,7800,20800,184080,98728452
2020-11-12,14343627,88004588,0,13000,112190,88116778
2020-11-13,15470340,94348528,0,13000,106860,94455388
2020-11-16,9654559,98161868,0,13000,107250,98269118
2020-11-17,7566457,100208416,0,13000,107250,100315666
2020-11-18,7129195,94789265,7800,20800,167856,94957121
2020-11-19,8168811,92154757,0,13000,106080,92260837
2020-11-20,13455638,95935306,0,13000,107120,96042426
2020-11-23,17484148,101414652,0,13000,107250,101521902
2020-11-24,9207512,99487274,2600,15600,126828,99614102
2020-11-25,7600694,98040670,1300,14300,114400,98155070
2020-11-26,7645446,96191709,0,13000,101920,96293629
2020-11-27,9709217,97722241,0,13000,99840,97822081
2020-11-30,4623589,96330195,0,13000,99190,96429385
2020-12-01,10605414,102097223,0,13000,98670,102195893
2020-12-02,9277325,101983144,0,13000,97500,102080644
2020-12-03,4313257,101409364,0,13000,97370,101506734
2020-12-04,5852261,99377627,0,13000,96590,99474217
2020-12-07,14774316,105855288,0,13000,95290,105950578
2020-12-08,12233646,113142763,0,13000,96200,113238963
2020-12-09,9236845,111387328,0,13000,91910,111479238
2020-12-10,2835362,106520184,0,3000,20940,106541124
2020-12-11,5332034,106980442,0,3000,20490,107000932
2020-12-14,4337261,102303314,0,3000,21300,102324614
2020-12-15,5132568,103948152,0,3000,21240,103969392
2020-12-16,1923873,101244910,0,3000,21120,101266030
2020-12-17,4267780,99721933,0,3000,21120,99743053
2020-12-18,4068641,96474768,0,3000,21480,96496248
2020-12-21,9339027,98532255,0,3000,22230,98554485
2020-12-22,6531889,91858870,0,3000,22470,91881340
2020-12-23,4588305,85163728,0,3000,23010,85186738
2020-12-24,8310413,88655016,0,3000,22590,88677606
2020-12-25,5182812,89594855,600,3600,26532,89621387
2020-12-28,8868970,86570667,0,3000,23190,86593857
2020-12-29,15316602,96450803,2500,5500,40150,96490953
2020-12-30,5130096,96510147,1600,5600,41160,96551307
2020-12-31,10097493,95674971,0,3100,22754,95697725
2021-01-04,13514402,98192769,0,3000,22500,98215269
2021-01-05,12862264,101186787,0,3000,22380,101209167
2021-01-06,16507522,109509499,500,3500,25095,109534594
2021-01-07,8691941,111624125,1000,4500,30420,111654545
2021-01-08,5028374,109527472,0,3500,23415,109550887
2021-01-11,3863584,111275745,0,3500,23205,111298950
2021-01-12,3794459,112479538,0,3500,23065,112502603
2021-01-13,5350097,113137874,0,3500,23065,113160939
2021-01-14,3675118,112763027,5000,8500,54740,112817767
2021-01-15,4651413,113349550,0,3000,19290,113368840
2021-01-18,3382368,114239538,0,3000,19290,114258828
2021-01-19,2553769,113169444,0,3000,19320,113188764
2021-01-20,26094862,114004313,7800,10800,76464,114080777
2021-01-21,21187810,107402556,0,3000,20340,107422896
2021-01-22,14150367,112886955,0,3000,20460,112907415
2021-01-25,4361833,114094675,0,3000,20340,114115015
2021-01-26,6277909,115787679,0,3000,20160,115807839
2021-01-27,3833651,116414755,0,3000,20190,116434945
2021-01-28,9196188,116223940,0,3000,19740,116243680
2021-01-29,2307430,114123360,1000,4000,25680,114149040
2021-02-01,3158262,114410826,0,3000,18930,114429756
2021-02-02,3588332,114026420,0,3000,19290,114045710
2021-02-03,3667767,113553895,0,3000,18990,113572885
2021-02-04,2707857,112108222,0,3000,18480,112126702
2021-02-05,2022966,111124346,7800,10800,67176,111191522
2021-02-08,554680,107016757,0,3000,18660,107035417
2021-02-09,3833736,99383720,2600,5600,37128,99420848
2021-02-10,3584974,97953178,0,5600,37184,97990362
2021-02-18,5815450,96902866,0,3000,20400,96923266
2021-02-19,7101830,92542153,0,3000,21660,92563813
2021-02-22,8217582,93356544,0,0,0,93356544
2021-02-23,4091832,90344702,7800,7800,56940,90401642
2021-02-24,5112278,90791706,0,7800,56550,90848256
2021-02-25,9999987,97509674,0,7800,56004,97565678
2021-02-26,6679846,100290124,0,7800,53352,100343476
2021-03-01,5555895,101227966,0,0,0,101227966
2021-03-02,8745020,97154898,3000,3000,21750,97176648
2021-03-03,4372243,96543830,0,0,0,96543830
2021-03-04,6454878,98866943,3000,3000,21540,98888483
2021-03-05,3508084,94845038,0,3000,22290,94867328
2021-03-08,3827768,88556393,0,3000,22500,88578893
2021-03-09,4513039,88007404,0,2700,19494,88026898
2021-03-10,11742996,90993044,6900,6900,52095,91045139
2021-03-11,3674077,88901161,0,500,3775,88904936
2021-03-12,3411682,87983485,1200,1200,8904,87992389
2021-03-15,4215533,86611396,2400,3600,27000,86638396
2021-03-16,7101544,85229584,2000,5600,44184,85273768
2021-03-17,5032009,85024530,0,3600,28440,85052970
2021-03-18,3515968,82374930,0,3600,28224,82403154
2021-03-19,6647587,84838158,1200,4800,36384,84874542
2021-03-22,3501166,84483341,600,5400,41202,84524543
2021-03-23,4064016,84043188,0,5400,40176,84083364
2021-03-24,10673944,90443836,5400,10800,79488,90523324
2021-03-25,9173316,96013666,0,10800,78840,96092506
2021-03-26,5598481,98271638,0,10800,78624,98350262
2021-03-29,7750653,96887228,0,10800,81324,96968552
2021-03-30,8676414,102980323,0,10800,78084,103058407
2021-03-31,2761436,96681708,0,10800,80460,96762168
2021-04-01,3919410,99076664,0,10800,80460,99157124
2021-04-02,5183883,100222034,0,10800,81000,100303034
2021-04-06,5877611,84806819,0,10800,85860,84892679
2021-04-07,3095407,83122087,0,10800,85968,83208055
2021-04-08,5306296,86253152,10000,20800,161616,86414768
2021-04-09,6377131,88894513,0,20800,163696,89058209
2021-04-12,4471939,91759135,0,20800,163280,91922415
2021-04-13,4597151,92142765,0,20800,156832,92299597
2021-04-14,11015678,99578707,0,20800,153712,99732419
2021-04-15,2696708,100651607,0,20800,154544,100806151
2021-04-16,5298725,102669442,0,20800,155792,102825234
2021-04-19,12995952,109168074,0,20800,155792,109323866
2021-04-20,8261275,109988677,0,20800,156208,110144885
2021-04-21,5944683,112591019,0,20800,154336,112745355
2021-04-22,2022370,113398603,0,13000,95420,113494023
2021-04-23,2141789,114300545,0,13000,96330,114396875
2021-04-26,5867562,114769989,0,13000,94510,114864499
2021-04-27,4188034,110203936,0,13000,93210,110297146
2021-04-28,1391247,108684386,0,13000,93340,108777726
2021-04-29,2055931,100158126,0,13000,92170,100250296
2021-04-30,5611242,98974990,0,13000,93600,99068590
2021-05-06,3578660,97966323,0,10000,70700,98037023
2021-05-07,4354916,101069649,3000,13000,91650,101161299
2021-05-10,3353672,101914087,0,13000,93600,102007687
2021-05-11,9317469,107170724,0,13000,92300,107263024
2021-05-12,2880599,105688382,0,13000,90740,105779122
2021-05-13,3903927,107271993,0,13000,89180,107361173
2021-05-14,2971034,106167035,0,13000,88920,106255955
2021-05-17,2950641,106656503,0,13000,87620,106744123
2021-05-18,2909667,108505060,0,13000,87750,108592810
2021-05-19,4011924,111375368,0,13000,88400,111463768
2021-05-20,1709686,107973919,0,13000,87880,108061799
2021-05-21,2133851,107430119,0,13000,88790,107518909
2021-05-24,1551542,108321193,0,13000,89440,108410633
2021-05-25,3324867,110606364,0,13000,89050,110695414
2021-05-26,2016054,110188983,0,13000,88270,110277253
2021-05-27,2690741,110876916,0,13000,88010,110964926
2021-05-28,805498,110044787,0,13000,88140,110132927
2021-05-31,1381973,110539408,0,13000,88530,110627938
2021-06-01,7356961,115655734,0,13000,89050,115744784
2021-06-02,6140928,115242321,0,13000,90740,115333061
2021-06-03,10392459,115413649,0,13000,88010,115501659
2021-06-04,2740795,113240908,0,3000,19980,113260888
2021-06-07,3244283,114450893,5000,8000,52800,114503693
2021-06-08,1142636,113777104,5000,13000,86840,113863944
2021-06-09,1974007,112449006,0,13000,85930,112534936
2021-06-10,2923983,112267980,0,13000,88270,112356250
2021-06-11,1973933,111983307,0,13000,88530,112071837
2021-06-15,1488240,110615251,0,13000,87230,110702481
2021-06-16,2290274,109590283,0,13000,86580,109676863
2021-06-17,1392251,109179179,0,13000,82160,109261339
2021-06-18,1968971,103381310,0,13000,84760,103466070
2021-06-21,5093955,105539727,0,13000,84760,105624487
2021-06-22,2301742,103627962,0,13000,83590,103711552
2021-06-23,3761799,104902494,0,13000,83720,104986214
2021-06-24,4587012,105497306,0,13000,85540,105582846
2021-06-25,6382941,107282878,0,13000,83330,107366208
2021-06-28,6169075,109499186,0,13000,84110,109583296
2021-06-29,1663126,109788292,0,13000,82550,109870842
2021-06-30,2234307,109339092,0,13000,82810,109421902
2021-07-01,1205213,107275230,0,13000,82290,107357520
2021-07-02,3197900,108502908,0,13000,81380,108584288
2021-07-05,1211662,106799421,0,13000,81510,106880931
2021-07-06,2556964,103048265,0,13000,80860,103129125
2021-07-07,1525506,102732161,0,13000,81120,102813281
2021-07-08,1103819,100828109,0,13000,80340,100908449
2021-07-09,2738604,90815496,0,10000,65000,90880496
2021-07-12,7475675,93374870,3000,13000,85410,93460280
2021-07-13,8683577,98344391,0,13000,85410,98429801
2021-07-14,5497424,97983876,0,13000,82550,98066426
2021-07-15,8131797,99609855,0,13000,81250,99691105
2021-07-16,8038406,105698481,0,13000,79820,105778301
2021-07-19,2443091,103800038,0,13000,78910,103878948
2021-07-20,2618937,104654897,0,10000,60300,104715197
2021-07-21,5215277,107831669,0,10000,60900,107892569
2021-07-22,4756894,109718464,9000,19000,115900,109834364
2021-07-23,3136169,110029192,0,19000,115900,110145092
2021-07-26,1951534,107085487,3000,22000,128040,107213527
2021-07-27,998591,106289196,7100,29100,165579,106454775
2021-07-28,589431,105468763,0,26100,146943,105615706
2021-07-29,2081445,106086322,4700,30800,172480,106258802
2021-07-30,2729077,104406150,3200,34000,184280,104590430
2021-08-02,6669995,106871071,0,34000,188020,107059091
2021-08-03,2259494,106428040,0,34000,186320,106614360
2021-08-04,4479723,107949575,0,34000,185640,108135215
2021-08-05,15496732,119147476,0,34000,187680,119335156
2021-08-06,4406178,114833531,0,34000,185640,115019171
2021-08-09,5011872,117041188,0,31000,171120,117212308
2021-08-10,13717483,124850910,0,31000,173600,125024510
2021-08-11,15868771,136044508,0,31000,179800,136224308
2021-08-12,33086842,152583383,0,31000,190960,152774343
2021-08-13,39668468,176970879,0,31000,197160,177168039
2021-08-16,10936956,173452407,0,31000,203670,173656077
2021-08-17,17220694,177062358,3000,34000,209780,177272138
2021-08-18,31840221,184154486,0,34000,226440,184380926
2021-08-19,7982116,180095740,0,33700,221409,180317149
2021-08-20,4664304,161639923,200,33900,223740,161863663
2021-08-23,14554642,169869964,0,33900,222045,170092009
2021-08-24,10591059,172824218,0,33600,220080,173044298
2021-08-25,11721734,174901448,400,34000,223380,175124828
2021-08-26,12038739,174706158,0,34000,221680,174927838
2021-08-27,9733006,173728346,0,31000,199950,173928296
2021-08-30,11138826,169452415,3000,34000,213180,169665595
2021-08-31,5275945,166129794,0,31000,195300,166325094
2021-09-01,4485766,159134178,0,21000,128730,159262908
2021-09-02,10613094,162969529,13000,34000,210460,163179989
2021-09-03,5411723,159039038,0,34000,206380,159245418
2021-09-06,27315134,177439515,0,34000,208760,177648275
2021-09-07,8651411,178275238,0,24000,147840,178423078
2021-09-08,7488595,180683102,0,24000,148320,180831422
2021-09-09,11129724,183923491,10000,34000,212840,184136331
2021-09-10,13859675,184453952,0,34000,217600,184671552
2021-09-13,27652902,201682229,0,33200,213144,201895373
2021-09-14,15752386,205447122,0,30200,186938,205634060
2021-09-15,8635725,205995392,0,30200,186334,206181726
2021-09-16,9694920,204977451,0,30200,179992,205157443
2021-09-17,2310553,196778859,0,30200,178180,196957039
2021-09-22,5639582,198665471,0,20200,118574,198784045
2021-09-23,3166437,195540742,0,20200,120190,195660932
2021-09-24,4077975,195765983,0,20200,117564,195883547
2021-09-27,4578112,191156875,0,20200,115544,191272419
2021-09-28,3647757,192242368,0,20200,116150,192358518
2021-09-29,3109974,191094173,3000,23200,131312,191225485
2021-09-30,1826069,184794652,0,22700,132341,184926993
2021-10-08,12602555,184353845,0,22700,136881,184490726
2021-10-11,12784236,190303721,0,20200,121604,190425325
2021-10-12,1797122,188175919,3000,23200,138736,188314655
2021-10-13,2274803,186159861,0,23200,141520,186301381
2021-10-14,5269793,184850654,0,23200,145232,184995886
2021-10-15,7226447,187262975,0,23200,146160,187409135
2021-10-18,3072318,182691960,0,23200,145696,182837656
2021-10-19,3065959,181855153,0,20200,124836,181979989
2021-10-20,4401559,180861463,0,20200,124028,180985491
2021-10-21,1860571,180302728,0,20200,122614,180425342
2021-10-22,9318530,181140562,0,20200,122816,181263378
2021-10-25,2782403,181420296,8200,28400,168696,181588992
2021-10-26,2142901,177249089,9200,31400,184004,177433093
2021-10-27,2068084,176301686,0,31400,181492,176483178
2021-10-28,1673247,177102136,0,31400,179608,177281744
2021-10-29,4586955,174649913,0,20200,114332,174764245
2021-11-01,6742860,169849595,3000,23200,144072,169993667
2021-11-02,25905717,162489021,0,23200,151496,162640517
2021-11-03,12306229,152071369,10000,33200,212812,152284181
2021-11-04,15653598,143640060,0,33200,213476,143853536
2021-11-05,9172257,144491288,0,33200,207832,144699120
2021-11-08,18434946,152280874,0,23200,137808,152418682
2021-11-09,10556375,152758804,10000,32400,188892,152947696
2021-11-10,8280107,155592464,0,32400,188892,155781356
2021-11-11,6401403,149400810,0,29400,174048,149574858
2021-11-12,9555567,139540710,0,29400,191394,139732104
2021-11-15,51345136,174123750,0,19400,129204,174252954
2021-11-16,41483614,176873005,0,19400,131726,177004731
2021-11-17,25495705,174042600,0,19400,134442,174177042
2021-11-18,24760123,172200006,3000,22400,153216,172353222
2021-11-19,35586890,174293252,0,22400,165312,174458564
2021-11-22,34416077,170694891,0,22400,173376,170868267
2021-11-23,27377340,164556745,0,12900,106296,164663041
2021-11-24,29983704,175164464,19900,29800,236612,175401076
2021-11-25,17715488,166738842,2000,31800,244542,166983384
2021-11-26,47490006,179461887,0,31800,263940,179725827
2021-11-29,30416232,193858697,0,31800,259170,194117867
2021-11-30,25820734,194742460,13000,43500,352350,195094810
2021-12-01,18105900,195439643,0,43500,368445,195808088
2021-12-02,23184124,151676328,3800,47300,405361,152081689
2021-12-03,32426152,161041112,0,44300,361488,161402600
2021-12-06,16994738,159011243,0,44300,336680,159347923
2021-12-07,20664296,171255064,0,31300,225360,171480424
2021-12-08,11883706,166102408,400,31700,235848,166338256
2021-12-09,14496269,171184912,13000,44700,320052,171504964
2021-12-10,29208224,175649782,0,44700,317370,175967152
2021-12-13,53888623,213679516,0,44300,319846,213999362
2021-12-14,28342470,200319560,3000,47300,375562,200695122
2021-12-15,42156663,193348866,0,47300,383130,193731996
2021-12-16,46310450,217452408,0,47300,392590,217844998
2021-12-17,10371393,215146099,0,47300,386441,215532540
2021-12-20,12189572,214904912,0,44300,346869,215251781
2021-12-21,13581448,216843394,0,44300,351742,217195136
2021-12-22,11299035,213975855,3000,47300,373197,214349052
2021-12-23,30836693,228977599,0,47300,385495,229363094
2021-12-24,14721312,218156709,0,47300,370359,218527068
2021-12-27,20288918,223918194,6600,50900,379714,224297908
2021-12-28,16291744,230462924,1100,35600,262728,230725652
2021-12-29,22420310,245102260,7900,37600,273728,245375988
2021-12-30,24301261,265830173,2300,35600,259880,266090053
2021-12-31,22162914,269555141,6600,19600,145432,269700573
2022-01-04,20903140,280837911,3000,22600,164302,281002213
2022-01-05,15410122,286124040,1800,18900,133434,286257474
2022-01-06,7897849,285102167,2100,19580,139997,285242164
2022-01-07,9107900,283521230,0,13000,92170,283613400
2022-01-10,7630781,283888961,0,13000,91910,283980871
2022-01-11,7685488,285832147,3000,16000,114880,285947027
2022-01-12,5171476,282832269,0,16000,115040,282947309
2022-01-13,9007613,274286328,3100,19100,134655,274420983
2022-01-14,7880135,269266990,7600,26700,187434,269454424
2022-01-17,7548721,268112452,0,23700,173010,268285462
2022-01-18,12211964,270272613,3400,17700,127086,270399699
2022-01-19,9129087,271058386,0,4700,33323,271091709
2022-01-20,9050425,269225382,0,4700,32195,269257577
2022-01-21,5755714,270569291,1900,6600,43956,270613247
2022-01-24,5158745,266410159,5300,11900,79968,266490127
2022-01-25,2910538,262958462,7200,19100,122813,263081275
2022-01-26,4063507,263175433,900,17000,111520,263286953
2022-01-27,2643467,261400565,3000,4000,25200,261425765
2022-01-28,1571214,254612080,900,4000,25120,254637200
2022-02-07,2904574,256445971,0,3200,20352,256466323
2022-02-08,6042405,258739372,0,200,1294,258740666
2022-02-09,3911670,257266862,0,200,1302,257268164
2022-02-10,3855336,256966073,17500,17700,115227,257081300
2022-02-11,3317418,255385636,3200,20900,131879,255517515
2022-02-14,4012318,256859439,400,21300,132912,256992351
2022-02-15,3542370,256083866,0,18300,114375,256198241
2022-02-16,5312869,255342561,3000,15100,96036,255438597
2022-02-17,1638125,253100258,0,15100,94224,253194482
2022-02-18,3446586,253650936,0,6900,43332,253694268
2022-02-21,2992571,250624394,0,4800,30192,250654586
2022-02-22,7477773,254968169,14600,18200,113204,255081373
2022-02-23,1977906,253077774,0,15500,97495,253175269
2022-02-24,6397602,255020317,8000,8300,50547,255070864
2022-02-25,3467294,254179432,0,1600,9984,254189416
2022-02-28,1886119,254590751,3000,3200,19808,254610559
2022-03-01,2432215,255108864,4400,4600,28750,255137614
2022-03-02,1254063,254390650,12100,12100,75746,254466396
2022-03-03,5807006,254337781,32100,44200,280228,254618009
2022-03-04,7981879,258300117,17500,55600,343608,258643725
2022-03-07,4315060,258151283,0,54400,328032,258479315
2022-03-08,9058602,261374033,6100,45400,264228,261638261
2022-03-09,6624319,260847680,4600,30600,174114,261021794
2022-03-10,3939103,259768880,900,31500,181440,259950320
2022-03-11,3064638,260388535,4400,35900,207861,260596396
2022-03-14,3672008,257746491,14100,47100,261405,258007896
2022-03-15,4236015,254346267,2900,38900,202280,254548547
2022-03-16,3706482,248371408,11100,37100,201453,248572861
2022-03-17,4435979,243604364,100,31300,174341,243778705
2022-03-18,2152066,234649380,0,0,0,234649380
2022-03-21,2329977,234481092,11100,11100,61716,234542808
2022-03-22,1301358,234187225,0,200,1120,234188345
2022-03-23,1552550,234540162,3000,3200,17920,234558082
2022-03-24,400248,234058428,7900,8100,44550,234102978
2022-03-25,1333535,232832368,14200,22300,122204,232954572
2022-03-28,1135699,233429378,2400,17800,97010,233526388
2022-03-29,1072148,232376889,3000,19600,104860,232481749
2022-03-30,1792554,228100848,0,9100,49868,228150716
2022-03-31,1395406,226436903,3000,8600,46784,226483687
2022-04-01,1117642,226083146,13900,15900,86814,226169960
2022-04-06,1298766,226041728,0,15900,87609,226129337
2022-04-07,2628586,226897264,3000,18900,100170,226997434
2022-04-08,467341,221968173,13800,29700,158895,222127068
2022-04-11,5400051,225749809,20600,34500,177330,225927139
2022-04-12,1025319,225846965,0,31500,164115,226011080
2022-04-13,4137303,225016354,3000,34500,174570,225190924
2022-04-14,856207,224395682,1400,32900,168777,224564459
2022-04-15,1788367,225166312,3000,32900,168119,225334431
2022-04-18,16627133,238428497,6100,36000,193320,238621817
2022-04-19,11176707,242833209,3000,28400,153076,242986285
2022-04-20,6271623,238116559,0,20200,110494,238227053
2022-04-21,3474596,238761876,16700,36900,192618,238954494
2022-04-22,2150475,238363065,1100,35000,181300,238544365
2022-04-25,3640715,235571488,16300,34000,159120,235730608
2022-04-26,2468476,233985313,17600,48600,214812,234200125
2022-04-27,1530300,231991701,1300,49900,234530,232226231
2022-04-28,992492,230653831,0,48600,225504,230879335
2022-04-29,1018535,230160553,12600,61200,290700,230451253
2022-05-05,2766419,230408037,3000,51300,240597,230648634
2022-05-06,977859,230463141,0,48300,221214,230684355
2022-05-09,599030,230656811,0,48300,222663,230879474
2022-05-10,778125,230172125,16700,65000,304200,230476325
2022-05-11,6757487,234487504,0,52900,272435,234759939
2022-05-12,7132147,237195340,12900,38400,196608,237391948
2022-05-13,5405800,237810900,25900,54600,284466,238095366
2022-05-16,17247284,249755816,3800,55400,294728,250050544
2022-05-17,15199892,259098583,5600,61000,324520,259423103
2022-05-18,2574513,258851053,0,34900,184970,259036023
2022-05-19,1055678,256638013,0,33900,179670,256817683
2022-05-20,3523540,257970718,3000,36900,197784,258168502
