日期,融资买入额(元),融资余额(元),融券卖出量,融券余量,融券余额(元),融资融券余额(元)
2017-07-12,19788512,1053799975,8900,8936,182562,1053982537
2017-07-13,41623578,1074713947,0,36,742,1074714689
2017-07-14,10112980,1067980570,8900,8936,184171,1068164741
2017-07-17,77566988,1021131251,0,36,668,1021131919
2017-07-18,79815047,1045961499,8900,8936,165673,1046127172
2017-07-19,29838034,1045787488,0,36,654,1045788142
2017-07-20,20669659,1035484346,8900,8936,164065,1035648411
2017-07-21,37359664,1028780053,0,8136,145309,1028925362
2017-07-24,18341835,1024106259,800,836,15015,1024121274
2017-07-25,10788329,1022859603,8100,8136,146529,1023006132
2017-07-26,12987986,1018968829,800,836,15073,1018983902
2017-07-27,62356384,1034813260,5600,5600,109200,1034922460
2017-07-28,23622034,1021368583,5000,5000,95100,1021463683
2017-07-31,26975425,1020781386,5600,7200,137952,1020919338
2017-08-01,12164306,1008042056,3400,5000,96100,1008138156
2017-08-02,20215437,1008082304,6200,7800,146406,1008228710
2017-08-03,19945400,1007755831,3800,6000,114420,1007870251
2017-08-04,22902501,995568558,5600,8200,159572,995728130
2017-08-07,13256191,981546018,200,2800,55188,981601206
2017-08-08,14053489,975120283,8800,11400,224808,975345091
2017-08-09,33233548,979636989,0,2600,52442,979689431
2017-08-10,53171667,980396703,9000,9000,189360,980586063
2017-08-11,42099195,979560606,0,0,0,979560606
2017-08-14,39710633,983150639,0,0,0,983150639
2017-08-15,24230463,981861410,9000,9000,190170,982051580
2017-08-16,43821999,978174552,0,0,0,978174552
2017-08-17,74641764,958319870,4400,4400,96800,958416670
2017-08-18,40565854,958158711,12585,12585,273346,958432057
2017-08-21,29220703,942179277,4400,4542,97426,942276703
2017-08-22,28214240,942163293,12400,15842,342187,942505480
2017-08-23,15661002,942921916,1100,1442,30931,942952847
2017-08-24,45890951,965565838,15515,15657,328327,965894165
2017-08-25,67783929,988056882,1300,1357,29013,988085895
2017-08-28,51567144,941781633,12700,12757,272234,942053867
2017-08-29,30966323,929549199,4200,11557,246511,929795710
2017-08-30,26620612,901965557,0,57,1202,901966759
2017-08-31,22352418,896512785,0,57,1192,896513977
2017-09-01,73443754,927511736,0,57,1230,927512966
2017-09-04,61704646,911703368,16900,16957,363897,912067265
2017-09-05,37422899,908157239,0,57,1227,908158466
2017-09-06,232657359,952928019,16900,16957,393063,953321082
2017-09-07,147884315,989653658,0,57,1304,989654962
2017-09-08,109718894,970449399,16900,16957,386620,970836019
2017-09-11,127392115,941404411,0,57,1351,941405762
2017-09-12,84435137,919378303,21900,21957,529822,919908125
2017-09-13,42513284,897583496,0,57,1345,897584841
2017-09-14,216445495,1007800783,31885,31942,793439,1008594222
2017-09-15,130617900,906921889,10000,20142,481394,907403283
2017-09-18,66654356,916865011,0,20142,485019,917350030
2017-09-19,309649529,1079767102,21800,41942,1096783,1080863885
2017-09-20,159164992,1045245435,0,26142,679953,1045925388
2017-09-21,102347317,1025828195,10800,30942,788402,1026616597
2017-09-22,336013266,1084267648,11000,31142,831180,1085098828
2017-09-25,159100197,1058243598,10800,35942,901785,1059145383
2017-09-26,130646076,1088207151,6000,31142,777927,1088985078
2017-09-27,205478678,1146261728,4000,24142,618035,1146879763
2017-09-28,141432488,1140647209,0,20142,497910,1141145119
2017-09-29,134133717,1124156355,5000,25142,639110,1124795465
2017-10-09,242006469,1156840347,16800,36942,981918,1157822265
2017-10-10,180743959,1167928556,8000,28142,769121,1168697677
2017-10-11,101996490,1149140334,16800,44942,1184222,1150324556
2017-10-12,113087844,1164334302,5800,33942,899463,1165233765
2017-10-13,178782205,1204156717,18500,52442,1365065,1205521782
2017-10-16,114586354,1183648537,4500,53842,1379432,1185027969
2017-10-17,137665973,1182016515,3100,43242,1066780,1183083295
2017-10-18,44917646,1089950348,18700,58842,1453397,1091403745
2017-10-19,88104584,1102408495,8100,53242,1306026,1103714521
2017-10-20,34107826,1100249047,700,50842,1263932,1101512979
2017-10-23,38089721,1070478134,0,50057,1258433,1071736567
2017-10-24,70398218,1087764339,13300,63357,1546544,1089310883
2017-10-25,28962080,1079192232,0,50057,1236408,1080428640
2017-10-26,92183432,1055917596,0,38057,968931,1056886527
2017-10-27,51979746,1037591761,18300,56357,1416815,1039008576
2017-10-30,66212811,1037370296,0,43057,1067814,1038438110
2017-10-31,98608319,1049366835,18800,61857,1616323,1050983158
2017-11-01,88678214,1048889710,0,48557,1273650,1050163360
2017-11-02,98349024,1090957867,13300,61857,1614468,1092572335
2017-11-03,125894573,1113307512,0,48557,1277049,1114584561
2017-11-06,166983470,1103974935,0,48557,1345514,1105320449
2017-11-07,120124666,1085240256,13300,51357,1434401,1086674657
2017-11-08,143781588,1090268556,0,38057,1035531,1091304087
2017-11-09,112297993,1103613519,18300,56357,1577432,1105190951
2017-11-10,274861860,1204710342,0,43057,1265876,1205976218
2017-11-13,189282594,1189696607,7900,50957,1525143,1191221750
2017-11-14,160276678,1197417345,0,43057,1291710,1198709055
2017-11-15,229583417,1243260021,12900,55957,1722916,1244982937
2017-11-16,209999636,1304307026,0,48057,1493131,1305800157
2017-11-17,181882947,1294846502,12900,60957,1759219,1296605721
2017-11-20,254434292,1325189325,0,53057,1684560,1326873885
2017-11-21,245641231,1270683105,7900,60957,1986589,1272669694
2017-11-22,281495574,1298618921,5000,58057,1946071,1300564992
2017-11-23,240708853,1283456089,7900,60957,1871380,1285327469
2017-11-24,221989494,1245355762,5000,58057,1731840,1247087602
2017-11-27,246619710,1350351486,7900,60957,1763486,1352114972
2017-11-28,204208569,1388758715,5000,58057,1821829,1390580544
2017-11-29,188633790,1425941360,7900,60957,1876256,1427817616
2017-11-30,178225521,1357183612,5000,58000,1711580,1358895192
2017-12-01,173884585,1359575347,5000,58000,1740000,1361315347
2017-12-04,169258114,1406215909,13000,71000,2107990,1408323899
2017-12-05,280046032,1506045220,0,63000,1758960,1507804180
2017-12-06,105520717,1497787653,8000,66000,1882320,1499669973
2017-12-07,83240997,1458856339,0,58000,1641400,1460497739
2017-12-08,130276635,1422245263,13000,66000,1937760,1424183023
2017-12-11,279343419,1511094214,0,48000,1454400,1512548614
2017-12-12,110945664,1495939175,8000,56000,1677200,1497616375
2017-12-13,106759707,1450615996,5000,43000,1302900,1451918896
2017-12-14,273804090,1406309516,20800,63800,2000768,1408310284
2017-12-15,217546305,1454665373,2200,55200,1684152,1456349525
2017-12-18,128768991,1493057113,5800,61000,1822680,1494879793
2017-12-19,90122996,1469658068,5000,58000,1789300,1471447368
2017-12-20,132648309,1423010308,8000,61000,1880630,1424890938
2017-12-21,186252886,1406662827,5000,43000,1385890,1408048717
2017-12-22,161091690,1419153570,8000,51000,1628430,1420782000
2017-12-25,123221724,1450294812,0,51000,1635570,1451930382
2017-12-26,146375720,1503978090,5000,48000,1514880,1505492970
2017-12-27,207195017,1574256722,18000,56000,1636880,1575893602
2017-12-28,84885435,1572779345,5000,53000,1537000,1574316345
2017-12-29,70873103,1588531598,8000,61000,1793400,1590324998
2018-01-02,94302955,1596530149,0,39400,1166240,1597696389
2018-01-03,146823198,1496521504,13600,43600,1353344,1497874848
2018-01-04,87281333,1492798938,4400,44400,1379952,1494178890
2018-01-05,198360676,1600306437,10500,54900,1656882,1601963319
2018-01-08,141689066,1635964451,6800,41800,1261106,1637225557
2018-01-09,219523376,1653383057,20100,55100,1731793,1655114850
2018-01-10,120077094,1669506257,6900,46900,1449210,1670955467
2018-01-11,182828909,1610550623,11800,41800,1328822,1611879445
2018-01-12,89304499,1584782132,10200,40200,1253034,1586035166
2018-01-15,178609982,1544133760,11800,36800,1093696,1545227456
2018-01-16,123863701,1564777901,10200,38300,1149383,1565927284
2018-01-17,230607667,1590277674,23700,48700,1401099,1591678773
2018-01-18,68986570,1586770938,13300,38300,1073549,1587844487
2018-01-19,77668556,1552938706,23700,48700,1314900,1554253606
2018-01-22,70856122,1542551539,13300,38300,1044824,1543596363
2018-01-23,95645261,1543753659,23700,48700,1269609,1545023268
2018-01-24,114078182,1566249200,13300,38300,1043292,1567292492
2018-01-25,90889328,1603900297,8300,33300,892773,1604793070
2018-01-26,45247109,1584763885,12200,37200,992124,1585756009
2018-01-29,75708178,1596399631,8700,33622,855344,1597254975
2018-01-30,17032062,1589090855,11200,36122,914609,1590005464
2018-01-31,30637826,1582729384,6700,36800,925520,1583654904
2018-02-01,49424930,1535326615,20600,45600,1040592,1536367207
2018-02-02,20172947,1520113155,11800,51200,1182720,1521295875
2018-02-05,18946873,1511032282,6200,31200,719472,1511751754
2018-02-06,34253413,1473753961,11800,36800,770960,1474524921
2018-02-07,31268621,1423578559,18500,43500,927420,1424505979
2018-02-08,36205926,1375021134,11800,11800,263140,1375284274
2018-02-09,47823678,1371956926,37796,37796,830378,1372787304
2018-02-12,37184573,1324113115,20197,26797,613651,1324726766
2018-02-13,40689461,1313923096,6200,6297,142879,1314065975
2018-02-14,13185710,1289096204,11700,11797,268146,1289364350
2018-02-22,52912707,1259131739,18700,18797,448308,1259580047
2018-02-23,31556926,1229286739,11700,24297,579726,1229866465
2018-02-26,215087316,1335356094,26700,39297,1031546,1336387640
2018-02-27,104749541,1194659275,10200,35197,908787,1195568062
2018-02-28,100681984,1132430049,7700,32797,850426,1133280475
2018-03-01,113600324,1157140864,23200,48297,1282768,1158423632
2018-03-02,101755508,1180298195,7700,32797,862561,1181160756
2018-03-05,124618311,1203444901,13200,38297,1030955,1204475856
2018-03-06,117026621,1169758798,12700,12797,342704,1170101502
2018-03-07,80847981,1181481016,13200,13297,348780,1181829796
2018-03-08,72205208,1176005306,12658,12755,333161,1176338467
2018-03-09,272748781,1295871774,43000,43055,1230942,1297102716
2018-03-12,161242214,1335093181,12700,37755,1081681,1336174862
2018-03-13,93449543,1346172423,18200,43255,1223684,1347396107
2018-03-14,95821776,1357051980,12700,37755,1060538,1358112518
2018-03-15,72026524,1339380284,18190,43245,1218644,1340598928
2018-03-16,49132727,1328537655,12700,37745,1037988,1329575643
2018-03-19,89526964,1339108348,18200,43245,1204806,1340313154
2018-03-20,59499908,1320441044,12700,37745,1037233,1321478277
2018-03-21,85028470,1302671344,18200,18245,501738,1303173082
2018-03-22,76596155,1329518584,13700,13745,378675,1329897259
2018-03-23,194076353,1397973171,44200,44245,1127363,1399100534
2018-03-26,111520278,1455406821,13700,38745,1030617,1456437438
2018-03-27,125054438,1400769215,19200,44245,1211871,1401981086
2018-03-28,85427480,1394999722,19700,44745,1220644,1396220366
2018-03-29,74483907,1389098183,21800,52845,1434742,1390532925
2018-03-30,192441502,1440246625,16100,47145,1354476,1441601101
2018-04-02,181876197,1372106227,21800,52845,1520879,1373627106
2018-04-03,138970429,1378001774,16100,47145,1380406,1379382180
2018-04-04,102338528,1366952778,21800,52845,1491286,1368444064
2018-04-09,107662722,1379076645,16065,47110,1345462,1380422107
2018-04-10,84058628,1331773558,21774,52784,1467395,1333240953
2018-04-11,62867609,1328904762,16100,47084,1305168,1330209930
2018-04-12,72587972,1226160776,21800,52784,1419890,1227580666
2018-04-13,52756715,1210267120,16036,47020,1269540,1211536660
2018-04-16,89223473,1235536997,19300,50320,1384303,1236921300
2018-04-17,331581040,1364547890,19200,50220,1404653,1365952543
2018-04-18,351789955,1327901496,24700,55720,1651541,1329553037
2018-04-19,286288846,1313216547,19200,50220,1435288,1314651835
2018-04-20,248647082,1307634687,24679,55699,1484935,1309119622
2018-04-23,145219096,1300498790,19200,50199,1288106,1301786896
2018-04-24,70401722,1250991509,24500,55499,1464064,1252455573
2018-04-25,125927547,1273091492,19200,50183,1359959,1274451451
2018-04-26,195232174,1356676127,24300,55242,1436292,1358112419
2018-04-27,70795061,1297383123,15166,46108,1202497,1298585620
2018-05-02,89088539,1279736551,24708,30716,756228,1280492779
2018-05-03,67112940,1263268748,44080,50096,1265926,1264534674
2018-05-04,40629530,1251456487,24400,55396,1379360,1252835847
2018-05-07,53907288,1236243475,14400,45420,1144584,1237388059
2018-05-08,42484776,1215728525,12800,43829,1107121,1216835646
2018-05-09,48816531,1191684700,14900,45929,1166597,1192851297
2018-05-10,50919877,1195489921,16700,48929,1243775,1196733696
2018-05-11,73997019,1127528474,18199,49228,1176057,1128704531
2018-05-14,86169026,1102020700,27200,58428,1414542,1103435242
2018-05-15,108255780,1162052787,16100,48628,1176798,1163229585
2018-05-16,90087671,1153185020,25900,58728,1441772,1154626792
2018-05-17,39819747,1137920990,16300,49128,1208549,1139129539
2018-05-18,79558010,1162060540,26200,59028,1481013,1163541553
2018-05-21,115532055,1150322624,10892,23484,619273,1150941897
2018-05-22,124100385,1143427584,23300,36484,989446,1144417030
2018-05-23,112821016,1153842677,9828,26896,700641,1154543318
2018-05-24,99152296,1181108150,19300,35796,922463,1182030613
2018-05-25,57584490,1176109784,11800,27796,709076,1176818860
2018-05-28,57389798,1154379130,26000,41796,1057439,1155436569
2018-05-29,66448795,1159153760,7800,30496,761790,1159915550
2018-05-30,65341566,1159443455,40500,61796,1473835,1160917290
2018-05-31,31725473,1153787844,10900,53796,1295408,1155083252
2018-06-01,26604529,1131255479,24900,46796,1122168,1132377647
2018-06-04,29905377,1126518021,10500,38866,931229,1127449250
2018-06-05,43761003,1111552282,7900,36270,892605,1112444887
2018-06-06,59714861,1095083574,10500,38870,982634,1096066208
2018-06-07,50769475,1101396870,18400,46770,1170185,1102567055
2018-06-08,62026030,1095871037,30880,58850,1485374,1097356411
2018-06-11,33149987,1093795617,18400,46650,1125665,1094921282
2018-06-12,33116402,1087385823,10500,38713,941887,1088327710
2018-06-13,28719354,1085552447,18230,46443,1118347,1086670794
2018-06-14,20464039,1078580194,12500,38960,938936,1079519130
2018-06-15,49749027,1075064495,20200,46660,1068514,1076133009
2018-06-19,47033955,1040162588,22500,48960,1009555,1041172143
2018-06-20,28203221,1035256953,20200,56660,1178528,1036435481
2018-06-21,48348136,1023568799,12521,49481,960921,1024529720
2018-06-22,25241088,1012570271,18400,57381,1153932,1013724203
2018-06-25,23534204,1003729962,8600,30581,605810,1004335772
2018-06-26,34395830,1010056953,13737,35018,718219,1010775172
2018-06-27,19889698,1003998229,19100,40418,822102,1004820331
2018-06-28,35823418,1004172820,13800,35118,705521,1004878341
2018-06-29,43076513,996005239,12500,33818,716942,996722181
2018-07-02,52234096,991593030,12500,33818,713560,992306590
2018-07-03,59771015,1001224831,25400,46718,1026862,1002251693
2018-07-04,31857475,994538714,12500,38818,829929,995368643
2018-07-05,34219260,992685940,20400,42418,863206,993549146
2018-07-06,33479329,987343018,12500,34518,715213,988058231
2018-07-09,43619704,1002245222,20400,36418,768420,1003013642
2018-07-10,47544542,993228626,16800,32818,712807,993941433
2018-07-11,38189902,985136954,22900,43177,905853,986042807
2018-07-12,105613608,1027064674,15000,35214,776821,1027841495
2018-07-13,46241900,1015725464,22100,42503,926565,1016652029
2018-07-16,59226195,1006406544,17300,37703,842285,1007248829
2018-07-17,40389700,989000272,24100,45703,1023290,990023562
2018-07-18,31370927,973752037,14800,37103,806990,974559027
2018-07-19,31858078,972770108,25300,45703,999982,973770090
2018-07-20,35740203,968862319,16600,37003,813696,969676015
2018-07-23,41166174,952085758,25300,45703,1039286,953125044
2018-07-24,49129532,954643006,15700,36103,819538,955462544
2018-07-25,42106147,960609481,24400,44803,1009860,961619341
2018-07-26,37549570,957506700,17000,37403,820996,958327696
2018-07-27,19820638,943752533,18200,39203,864818,944617351
2018-07-30,26642230,947149005,15600,36003,765064,947914069
2018-07-31,13090470,938078252,23500,43903,939963,939018215
2018-08-01,28041844,932951336,14400,34803,751745,933703081
2018-08-02,28256875,928927645,25300,45703,955193,929882838
2018-08-03,18116394,923941983,17400,38603,776692,924718675
2018-08-06,15070149,923428502,24484,44887,891905,924320407
2018-08-07,17842469,915704739,18200,38587,812642,916517381
2018-08-08,33065683,907867445,24500,44887,960133,908827578
2018-08-09,60799178,899775456,18200,38550,876627,900652083
2018-08-10,55357953,884017313,24600,44950,1045987,885063300
2018-08-13,66396961,886678429,18300,38650,929146,887607575
2018-08-14,34871440,889837852,24600,44950,1066664,890904516
2018-08-15,45490192,889120929,18300,38650,904797,890025726
2018-08-16,69583193,887732181,24600,44950,1075654,888807835
2018-08-17,69067515,861720168,18300,38650,946925,862667093
2018-08-20,82964080,884341881,24567,39917,987147,885329028
2018-08-21,78269063,908778956,18300,33643,819880,909598836
2018-08-22,76207997,912600005,24579,39922,967709,913567714
2018-08-23,92663263,915431536,23300,38622,963233,916394769
2018-08-24,69995338,891926214,24595,44917,1085195,893011409
2018-08-27,118309550,879260866,18300,38645,999360,880260226
2018-08-28,83894274,873176070,22082,42427,1103102,874279172
2018-08-29,51696281,877160618,18300,45727,1198047,878358665
2018-08-30,159353833,938408639,17500,37827,994850,939403489
2018-08-31,69878514,926295584,25400,40727,1049942,927345526
2018-09-03,77886327,886577424,31000,46327,1225812,887803236
2018-09-04,86007416,868504296,27400,56227,1495076,869999372
2018-09-05,93568522,855687657,17500,48383,1309244,856996901
2018-09-06,68439109,854380503,24143,55026,1485152,855865655
2018-09-07,92295631,851496416,18700,49526,1264894,852761310
2018-09-10,62092427,855117337,24200,50026,1263157,856380494
2018-09-11,69268879,863219665,23700,49526,1289162,864508827
2018-09-12,62520865,850517865,24200,55011,1386277,851904142
2018-09-13,133265844,854403246,18890,49701,1350873,855754119
2018-09-14,125679697,877104696,32684,59185,1547096,878651792
2018-09-17,60720271,869396559,23000,53555,1397250,870793809
2018-09-18,65901850,868571738,32400,65455,1714266,870286004
2018-09-19,95434006,885976565,25300,62155,1634055,887610620
2018-09-20,57229040,857990871,28554,67309,1797823,859788694
2018-09-21,68495183,858455726,25100,63809,1694129,860149855
2018-09-25,83937976,858333050,30938,71447,1952647,860285697
2018-09-26,86626474,862097471,25755,66302,1802088,863899559
2018-09-27,69156638,857473809,29500,70402,1915638,859389447
2018-09-28,66839646,837333253,25543,66445,1773417,839106670
2018-10-08,71830374,841412497,30800,71645,1763183,843175680
2018-10-09,38222926,839361913,25529,66347,1638771,841000684
2018-10-10,35990957,841603990,30800,71548,1752927,843356917
2018-10-11,52883635,817904026,25456,65204,1449485,819353511
2018-10-12,48027253,797405992,30700,70504,1641333,799047325
2018-10-15,32341591,789277872,27500,67304,1573567,790851439
2018-10-16,43802573,803031310,30700,72504,1638591,804669901
2018-10-17,77967281,795193683,25500,67304,1568183,796761866
2018-10-18,40737939,789507681,30700,72492,1652818,791160499
2018-10-19,37136279,768223727,25319,67011,1587491,769811218
2018-10-22,65174564,759382496,30800,72611,1886434,761268930
2018-10-23,38072677,748869852,26489,68300,1762140,750631992
2018-10-24,46263505,760772112,30800,73700,1911041,762683153
2018-10-25,57671160,753913487,25400,68300,1827026,755740513
2018-10-26,65700165,756797156,30739,73639,1941860,758739016
2018-10-29,46502419,754018952,25400,68039,1801673,755820625
2018-10-30,70449481,745167293,31000,73639,1896205,747063498
2018-10-31,51755453,765039019,25300,68139,1749809,766788828
2018-11-01,64811725,774098734,30800,73639,1891786,775990520
2018-11-02,77732989,771335957,25400,67150,1789548,773125505
2018-11-05,64353781,757583513,8700,50301,1359636,758943149
2018-11-06,41844641,761453038,9900,51501,1381257,762834295
2018-11-07,100088819,780218460,14200,55787,1534143,781752603
2018-11-08,59613994,749077086,16600,58187,1547775,750624861
2018-11-09,188504483,848466008,18900,60487,1687587,850153595
2018-11-12,92635632,762897794,7300,45601,1308749,764206543
2018-11-13,84352683,756786748,9500,45601,1285948,758072696
2018-11-14,69160220,775274978,4800,45601,1273180,776548158
2018-11-15,89485863,779394178,10700,50001,1406528,780800706
2018-11-16,82206824,771550146,7100,50090,1423558,772973704
2018-11-19,53165817,756622721,7300,39890,1118915,757741636
2018-11-20,61436835,760577607,11600,44790,1211570,761789177
2018-11-21,42670677,770047460,9000,44690,1195011,771242471
2018-11-22,22843278,768649542,4700,42290,1129143,769778685
2018-11-23,34373530,758798428,8700,43990,1152538,759950966
2018-11-26,41455191,753104730,8800,43690,1179630,754284360
2018-11-27,50168811,754784282,10000,43890,1193808,755978090
2018-11-28,47471549,761603084,9000,41390,1126222,762729306
2018-11-29,68784693,774669408,9100,38990,1016079,775685487
2018-11-30,39351087,761953995,9000,38990,1031675,762985670
2018-12-03,87954058,758836679,9000,38690,1072487,759909166
2018-12-04,43085952,753929252,3400,34990,970273,754899525
2018-12-05,32786248,760529409,10500,39390,1071408,761600817
2018-12-06,91261568,796909974,7600,37890,952555,797862529
2018-12-07,34487967,795444696,5000,38090,966724,796411420
2018-12-10,42994009,793572005,12400,42990,1098395,794670400
2018-12-11,42074951,796278447,1200,42990,1110432,797388879
2018-12-12,26409247,792971129,0,42990,1103983,794075112
2018-12-13,39455472,791351311,800,42990,1122039,792473350
2018-12-14,34579592,788354377,3800,40490,1036949,789391326
2018-12-17,20181274,783995772,3800,40490,1027636,785023408
2018-12-18,24419667,786216390,4300,38990,989956,787206346
2018-12-19,42311628,792613471,3800,38990,996195,793609666
2018-12-20,36042416,801606783,4500,39690,1016461,802623244
2018-12-21,36413651,799670037,3800,39690,1024002,800694039
2018-12-24,127295819,830349495,3800,39690,1071630,831421125
2018-12-25,126413257,849696260,3000,39690,1083140,850779400
2018-12-26,80540099,846255212,3800,39190,1048333,847303545
2018-12-27,63855453,834932564,11800,47190,1267995,836200559
2018-12-28,51093975,814377390,3800,35790,961319,815338709
2019-01-02,45190441,814175078,3800,35790,956309,815131387
2019-01-03,70175041,814488136,19800,51790,1315984,815804120
2019-01-04,36791986,807451310,3800,35814,924001,808375311
2019-01-07,77210943,803966912,19700,51714,1392658,805359570
2019-01-08,43226274,792910094,3800,35714,956421,793866515
2019-01-09,65881876,800393744,19800,51714,1378178,801771922
2019-01-10,73075583,818375538,10100,41014,1099175,819474713
2019-01-11,130910256,854549155,26100,53314,1440544,855989699
2019-01-14,68446919,849560098,12900,41114,1112956,850673054
2019-01-15,68839579,859532386,22400,55614,1519931,861052317
2019-01-16,45967073,859151306,0,37114,1004676,860155982
2019-01-17,44282869,851569155,8600,41814,1115179,852684334
2019-01-18,52981719,853788063,14800,47814,1267549,855055612
2019-01-21,67950931,852440882,12500,46514,1263320,853704202
2019-01-22,50203745,835655549,3800,36814,976675,836632224
2019-01-23,27150264,840414595,10700,44914,1183484,841598079
2019-01-24,52060445,849577281,3900,38414,1019892,850597173
2019-01-25,21688905,824639858,4200,37314,980612,825620470
2019-01-28,26328037,806627475,11800,39814,1047506,807674981
2019-01-29,39144643,800381107,4500,25514,660813,801041920
2019-01-30,28911231,789926136,12900,33800,876772,790802908
2019-01-31,27142183,777340389,4900,28900,751400,778091789
2019-02-01,29977145,754759443,0,27900,741582,755501025
2019-02-11,70493612,765704802,8600,36500,993165,766697967
2019-02-12,57918448,759274181,1600,20300,552769,759826950
2019-02-13,144252502,783117129,18700,37400,1056176,784173305
2019-02-14,90858551,805976405,3600,33000,923670,806900075
2019-02-15,73535887,797860935,17700,46900,1307103,799168038
2019-02-18,121516070,789930560,13900,45200,1314416,791244976
2019-02-19,103056127,796260080,15900,54500,1570690,797830770
2019-02-20,81173444,806646820,10300,50200,1447266,808094086
2019-02-21,333577900,932385868,14600,47800,1487058,933872926
2019-02-22,216877450,889128713,11100,44000,1449360,890578073
2019-02-25,335605070,968955199,20755,52155,1757624,970712823
2019-02-26,267882404,978268267,5100,40555,1322093,979590360
2019-02-27,195892159,1029468509,15800,51255,1627346,1031095855
2019-02-28,131071769,1065393633,11000,47355,1523410,1066917043
2019-03-01,118028707,1058562276,11600,47955,1529765,1060092041
2019-03-04,239364103,1067378009,19100,55055,1762311,1069140320
2019-03-05,199813267,1019834832,14900,50855,1684318,1021519150
2019-03-06,203119409,1048293547,18700,54755,1789393,1050082940
2019-03-07,175850492,1034368464,14800,50755,1604873,1035973337
2019-03-08,447615989,1234000286,18800,54755,1783918,1235784204
2019-03-11,293036596,1272330584,9300,45255,1537765,1273868349
2019-03-12,352153876,1265334970,29300,61755,2133018,1267467988
2019-03-13,201087534,1282371290,9300,41755,1344929,1283716219
2019-03-14,204575801,1250769770,29300,61755,2093495,1252863265
2019-03-15,155369322,1251330535,11500,43955,1454911,1252785446
2019-03-18,117055423,1216581469,21200,53655,1807100,1218388569
2019-03-19,154482131,1220565093,20500,53455,1804106,1222369199
2019-03-20,111262600,1226712422,9100,45255,1504729,1228217151
2019-03-21,139850996,1247036167,9300,45155,1503662,1248539829
2019-03-22,111695581,1220591907,17300,52955,1722097,1222314004
2019-03-25,102798457,1233973602,11900,50055,1592750,1235566352
2019-03-26,115855298,1213023660,15600,50355,1528274,1214551934
2019-03-27,56006781,1198349115,17600,50155,1535245,1199884360
2019-03-28,117858286,1198790122,11600,45460,1408805,1200198927
2019-03-29,130224383,1216137752,28100,61960,1955458,1218093210
2019-04-01,165376217,1219177944,10300,45260,1460993,1220638937
2019-04-02,175740244,1282171799,21900,56560,1791255,1283963054
2019-04-03,128538694,1294012141,14100,48760,1530089,1295542230
2019-04-04,101700266,1292940889,10000,48760,1519849,1294460738
2019-04-08,109814654,1300194446,10000,46660,1436661,1301631107
2019-04-09,84566048,1303537448,32000,68660,2130520,1305667968
2019-04-10,116443414,1309044377,18000,53160,1677730,1310722107
2019-04-11,59098977,1271511775,12900,44960,1373078,1272884853
2019-04-12,55644649,1275305908,22200,53960,1639305,1276945213
2019-04-15,98385456,1245584407,15800,48560,1473796,1247058203
2019-04-16,191765358,1288999958,24000,54712,1764462,1290764420
2019-04-17,145475900,1272938569,17300,51712,1639788,1274578357
2019-04-18,137330390,1282623622,23500,61012,1952384,1284576006
2019-04-19,131092104,1288017764,14200,52312,1669799,1289687563
2019-04-22,183839380,1302768022,22900,61012,1954214,1304722236
2019-04-23,97930799,1290342867,10200,47712,1487183,1291830050
2019-04-24,92791280,1306392747,21500,58212,1842992,1308235739
2019-04-25,112399636,1298421054,12300,49012,1472320,1299893374
2019-04-26,58040614,1282772876,22200,59112,1749715,1284522591
2019-04-29,85442263,1285471775,12100,44512,1243665,1286715440
2019-04-30,37364619,1271118047,15400,43112,1212741,1272330788
2019-05-06,75857824,1233616783,24900,49312,1248580,1234865363
2019-05-07,34562216,1224576067,19900,45612,1159457,1225735524
2019-05-08,28443968,1212412071,27700,52112,1311659,1213723730
2019-05-09,21638093,1210164495,26014,50926,1270603,1211435098
2019-05-10,71493125,1194896720,26800,61012,1605836,1196502556
2019-05-13,36204940,1178292138,16800,48812,1253980,1179546118
2019-05-14,40941084,1187414698,27500,54712,1396797,1188811495
2019-05-15,38025274,1185044602,10900,35960,929926,1185974528
2019-05-16,37273328,1176617771,17100,44600,1147112,1177764883
2019-05-17,56519100,1172011453,22100,50100,1268532,1173279985
2019-05-20,96762400,1200120907,20000,58100,1540812,1201661719
2019-05-21,65761792,1175629944,12000,46600,1247948,1176877892
2019-05-22,94353028,1190674469,22900,50600,1377838,1192052307
2019-05-23,47038895,1178768697,18900,56600,1489712,1180258409
2019-05-24,45241915,1174179337,12900,44100,1135575,1175314912
2019-05-27,54640269,1178420869,25476,53276,1421404,1179842273
2019-05-28,43380926,1168554370,15900,44176,1174198,1169728568
2019-05-29,39325819,1165427377,25400,53176,1417140,1166844517
2019-05-30,25762226,1164476983,20100,48576,1275606,1165752589
2019-05-31,33096991,1163785120,19600,40176,1060646,1164845766
2019-06-03,89948847,1171874942,60000,80076,2193282,1174068224
2019-06-04,116967026,1183598384,22251,60827,1701331,1185299715
2019-06-05,104627563,1185252201,39800,71027,2007933,1187260134
2019-06-06,85760888,1183948414,20400,41727,1107852,1185056266
2019-06-10,58714245,1178906169,61556,83081,2258972,1181165141
2019-06-11,106415113,1203378201,23600,61681,1712882,1205091083
2019-06-12,82581919,1190445657,18100,53825,1474805,1191920462
2019-06-13,46575419,1190904810,21200,46725,1276059,1192180869
2019-06-14,49122330,1183569970,20700,50225,1334981,1184904951
2019-06-17,29789132,1178566903,16900,41625,1091408,1179658311
2019-06-18,21865635,1175378331,57021,84846,2234843,1177613174
2019-06-19,57898078,1166516549,19800,54525,1450910,1167967459
2019-06-20,56060609,1164989536,25204,46729,1259347,1166248883
2019-06-21,57702442,1153645611,48300,65529,1783699,1155429310
2019-06-24,58171939,1168776618,24100,39229,1047414,1169824032
2019-06-25,36166770,1163814753,29200,44929,1184329,1164999082
2019-06-26,29594263,1163397779,27200,55129,1451547,1164849326
2019-06-27,107524367,1196414494,27500,54929,1483632,1197898126
2019-06-28,45925896,1190044927,12500,43829,1160592,1191205519
2019-07-01,107059893,1216154601,26500,48129,1316328,1217470929
2019-07-02,50701876,1219430023,25800,49029,1328195,1220758218
2019-07-03,42783080,1225666691,25100,48629,1291100,1226957791
2019-07-04,31901157,1227966604,16100,52129,1387674,1229354278
2019-07-05,18985493,1221920274,14900,54429,1444546,1223364820
2019-07-08,37955386,1213337555,21600,49101,1248148,1214585703
2019-07-09,14839149,1206895254,22600,55517,1411242,1208306496
2019-07-10,11313634,1206374569,11635,52852,1336098,1207710667
2019-07-11,10348733,1196707533,14400,62217,1575957,1198283490
2019-07-12,14081425,1186734296,20900,51517,1308532,1188042828
2019-07-15,25899242,1181824392,44500,74517,1916577,1183740969
2019-07-16,54404561,1171802783,25700,58017,1536870,1173339653
2019-07-17,36579220,1170063965,9600,56117,1480367,1171544332
2019-07-18,23894817,1166933226,15963,56580,1454671,1168387897
2019-07-19,37204087,1182681445,27200,58480,1494164,1184175609
2019-07-22,18385827,1171712920,37500,65780,1641211,1173354131
2019-07-23,14974367,1164484238,27600,78380,1993204,1166477442
2019-07-24,40031808,1132633766,16400,61180,1583339,1134217105
2019-07-25,42483669,1113647708,25500,53480,1403315,1115051023
2019-07-26,37716470,1098395705,8900,46180,1221923,1099617628
2019-07-29,46584043,1097523582,28100,44780,1196073,1098719655
2019-07-30,106585319,1083619594,43405,62885,1740028,1085359622
2019-07-31,79056817,1093085695,38991,69423,1931348,1095017043
2019-08-01,50394254,1085546504,16400,71323,1988485,1087534989
2019-08-02,63872425,1073560942,26100,60223,1651315,1075212257
2019-08-05,90437855,1079475016,34104,68227,1881700,1081356716
2019-08-06,116368343,1099719747,21600,68627,1927046,1101646793
2019-08-07,109594012,1125995527,31400,75727,2044629,1128040156
2019-08-08,50496247,1122113084,22000,73127,1989785,1124102869
2019-08-09,61434652,1100984107,24500,66827,1754209,1102738316
2019-08-12,73903071,1097129433,26100,51227,1385178,1098514611
2019-08-13,47201337,1097813299,29600,56627,1528363,1099341662
2019-08-14,100144891,1111808140,17500,48027,1289044,1113097184
2019-08-15,50906196,1088627394,37100,61627,1663929,1090291323
2019-08-16,58233967,1090245897,25576,63503,1722836,1091968733
2019-08-19,107390450,1073478560,26800,59503,1696431,1075174991
2019-08-20,67385753,1072469388,28300,58803,1651188,1074120576
2019-08-21,56746851,1074983255,24100,58932,1658936,1076642191
2019-08-22,49599443,1077716317,27700,70332,1949603,1079665920
2019-08-23,49890593,1064586304,21900,61810,1679378,1066265682
2019-08-26,90593396,1058308369,20700,67810,1916989,1060225358
2019-08-27,124623211,1067136676,23700,69010,1982657,1069119333
2019-08-28,61243898,1054496874,23600,71910,2063817,1056560691
2019-08-29,61689865,1054137182,25000,74390,2112676,1056249858
2019-08-30,94777092,1049008505,22418,73708,2105100,1051113605
2019-09-02,141986003,1101266918,24100,74708,2197910,1103464828
2019-09-03,115373918,1094002638,25100,76208,2295385,1096298023
2019-09-04,88895590,1060637595,21300,72608,2182596,1062820191
2019-09-05,197689367,1042870917,19000,79308,2504546,1045375463
2019-09-06,185366441,1045960317,23400,77508,2477155,1048437472
2019-09-09,193038436,993040921,12900,69908,2293682,995334603
2019-09-10,123677679,1001092743,29600,77208,2445949,1003538692
2019-09-11,78020371,1001146291,10400,74271,2327653,1003473944
2019-09-12,49915744,975932690,22200,69671,2225292,978157982
2019-09-16,107662532,996404313,11600,63171,2002521,998406834
2019-09-17,69753600,975513103,17800,65271,1992724,977505827
2019-09-18,48425799,966017215,20100,73971,2269430,968286645
2019-09-19,58857131,978048506,4800,58771,1820726,979869232
2019-09-20,68808621,979495476,17500,67000,2045510,981540986
2019-09-23,50495767,947644169,10200,62500,1900625,949544794
2019-09-24,133921414,979615694,23000,75600,2366280,981981974
2019-09-25,64072019,948448999,13200,56100,1680756,950129755
2019-09-26,69021518,950706604,33000,74800,2141524,952848128
2019-09-27,37774267,944430747,7200,69400,2006354,946437101
2019-09-30,33176341,918895315,18900,66400,1888416,920783731
2019-10-08,25782920,912115658,29900,85200,2422236,914537894
2019-10-09,38039491,911793135,17000,81800,2379562,914172697
2019-10-10,46408521,913578662,21900,85600,2503800,916082462
2019-10-11,44032617,919666419,4900,57076,1647213,921313632
2019-10-14,31949155,899539389,25500,73776,2174179,901713568
2019-10-15,31461210,901236926,2400,73576,2121931,903358857
2019-10-16,13235732,892033177,3800,57576,1661643,893694820
2019-10-17,15728248,880447654,11700,67376,1951209,882398863
2019-10-18,35327243,873211881,21600,74576,2176874,875388755
2019-10-21,22879009,867570370,4700,56214,1606596,869176966
2019-10-22,31511889,874263929,18900,70614,2018854,876282783
2019-10-23,34304308,879067899,8500,69914,1947105,881015004
2019-10-24,55527321,868278450,18500,45014,1215828,869494278
2019-10-25,29319765,855869662,8700,36614,981987,856851649
2019-10-28,51922509,862793617,20800,45314,1260182,864053799
2019-10-29,27450088,860097144,10300,45414,1230720,861327864
2019-10-30,28934448,865948331,19200,55114,1467685,867416016
2019-10-31,28615696,864149007,22700,71376,1941427,866090434
2019-11-01,30606944,863548331,13200,61176,1663376,865211707
2019-11-04,51395204,878542788,11800,47666,1308908,879851696
2019-11-05,33330408,874429562,32370,75536,2087815,876517377
2019-11-06,39061608,878161219,4900,56036,1539309,879700528
2019-11-07,24434619,877962032,4600,51036,1405532,879367564
2019-11-08,37617233,871811469,9500,55636,1553913,873365382
2019-11-11,44551295,856392979,11981,54911,1521035,857914014
2019-11-12,37899453,858824268,11000,38411,1055150,859879418
2019-11-13,23535666,856864381,6400,36411,1004944,857869325
2019-11-14,38932721,853296549,34100,70311,1984880,855281429
2019-11-15,45715397,855471810,22900,78311,2196624,857668434
2019-11-18,30176446,855382497,6700,83411,2359697,857742194
2019-11-19,84558064,882543200,9400,83108,2417612,884960812
2019-11-20,51491713,897097198,10700,87308,2497882,899595080
2019-11-21,31325323,895901203,10900,83008,2349957,898251160
2019-11-22,46362322,870639163,7800,82608,2375806,873014969
2019-11-25,40193809,866995185,5600,68608,1930629,868925814
2019-11-26,22020552,863983112,20200,85808,2411205,866394317
2019-11-27,28644148,866868251,10900,88808,2486624,869354875
2019-11-28,21580663,865688733,5900,75908,2128460,867817193
2019-11-29,15613190,852364249,27356,83464,2328645,854692894
2019-12-02,42648765,858533135,21000,88364,2519258,861052393
2019-12-03,37356619,848261285,4600,72964,2097715,850359000
2019-12-04,27574823,849189950,23500,92764,2655833,851845783
2019-12-05,69992175,859872822,21601,105365,3090356,862963178
2019-12-06,43549656,852331338,22600,126965,3720074,856051412
2019-12-09,59760399,872355389,20700,67408,1951462,874306851
2019-12-10,68119727,882763456,35200,82808,2457741,885221197
2019-12-11,70395057,895603220,27100,74908,2171583,897774803
2019-12-12,88174358,914738789,37000,84808,2502684,917241473
2019-12-13,78221246,919409806,23700,63708,1880023,921289829
2019-12-16,80828040,916778863,21400,63808,1919983,918698846
2019-12-17,141681802,942850802,103000,140708,4219833,947070635
2019-12-18,90903812,921851266,30468,121876,3698936,925550202
2019-12-19,51330072,914394177,24000,117276,3547599,917941776
2019-12-20,77431263,911019093,22800,120476,3526333,914545426
2019-12-23,41082012,904120041,23400,53276,1519964,905640005
2019-12-24,27337181,886116565,48200,82976,2385560,888502125
2019-12-25,92018123,901553825,67700,128076,3803858,905357683
2019-12-26,65943973,898171938,69900,142676,4214649,902386587
2019-12-27,61966156,899155349,34600,156776,4632731,903788080
2019-12-30,54548823,894612029,30200,155576,4597271,899209300
2019-12-31,36824913,878144387,11100,147376,4388857,882533244
2020-01-02,66729399,867563915,14500,154276,4674563,872238478
2020-01-03,47722416,845661990,3000,150876,4594174,850256164
2020-01-06,69185245,829517095,6500,156876,4823937,834341032
2020-01-07,58103840,839364716,8600,163476,5005635,844370351
2020-01-08,59144876,823976106,4600,160676,4794572,828770678
2020-01-09,142582930,848976740,22800,175676,5561902,854538642
2020-01-10,94244062,856225354,7700,148576,4714316,860939670
2020-01-13,96025306,868897426,10100,143576,4588689,873486115
2020-01-14,72000604,860935964,2700,101276,3164875,864100839
2020-01-15,42277910,851144704,17600,108376,3388918,854533622
2020-01-16,72897907,871286804,2300,107545,3383366,874670170
2020-01-17,67741261,877107105,0,90045,2849925,879957030
2020-01-20,92034180,875599291,10900,88345,2857077,878456368
2020-01-21,63470401,835510245,6800,35345,1109833,836620078
2020-01-22,59699204,806544065,7486,32831,1045996,807590061
2020-01-23,94457680,793383720,9697,34028,1005528,794389248
2020-02-03,6165880,761473093,0,25328,673725,762146818
2020-02-04,81529010,747910398,0,24928,639902,748550300
2020-02-05,84452533,766410692,0,24928,661589,767072281
2020-02-06,63564147,752670365,1000,25028,686017,753356382
2020-02-07,73432741,750096923,1200,24428,688381,750785304
2020-02-10,38181580,738003080,2700,16328,464858,738467938
2020-02-11,39388224,722742499,24100,36218,1019175,723761674
2020-02-12,43879499,728819388,12900,39518,1135352,729954740
2020-02-13,39545238,723898009,6700,34318,974631,724872640
2020-02-14,87295906,748449549,15100,40118,1156201,749605750
2020-02-17,62037457,744797223,5800,32518,972613,745769836
2020-02-18,72777173,756311847,27400,53718,1633564,757945411
2020-02-19,65435477,764324162,6200,43918,1319297,765643459
2020-02-20,66716637,763614002,4400,47018,1429347,765043349
2020-02-21,139933502,783733005,8800,51018,1614720,785347725
2020-02-24,239130564,859956058,6100,38918,1322823,861278881
2020-02-25,249876893,895128681,17000,48818,1708142,896836823
2020-02-26,229583917,939725581,11400,45618,1455214,941180795
2020-02-27,104500689,928643764,13700,43918,1400984,930044748
2020-02-28,107288544,897863978,29500,58818,1757482,899621460
2020-03-02,135160551,888931953,46400,95718,3105092,892037045
2020-03-03,167622727,875131186,16500,99618,3187776,878318962
2020-03-04,121657814,902692789,13100,98818,3235301,905928090
2020-03-05,151922104,897029486,45790,133808,4463835,901493321
2020-03-06,96084881,836220602,21300,144008,4745064,840965666
2020-03-09,148294543,821977517,75300,211808,6883760,828861277
2020-03-10,312240016,922286481,26900,208608,7457736,929744217
2020-03-11,400486135,986945897,60200,234908,8224129,995170026
2020-03-12,212180502,909920056,387404,584512,20130594,930050650
2020-03-13,224134179,955960385,145126,698838,23683620,979644005
2020-03-16,177194422,891401665,139861,726399,22162433,913564098
2020-03-17,114978458,881958939,78200,677599,21012345,902971284
2020-03-18,136011293,881812879,127200,633234,19446616,901259495
2020-03-19,112290956,866474596,330500,875134,28354341,894828937
2020-03-20,96140278,859026363,146800,921534,29940640,888967003
2020-03-23,195025864,879597138,362978,1129312,38102987,917700125
2020-03-24,231437154,884503777,310100,1034186,37241038,921744815
2020-03-25,207786563,917555473,363635,1136043,40090957,957646430
2020-03-26,129342817,934019398,244343,1184674,40823866,974843264
2020-03-27,96087152,908138088,212700,1264652,42365843,950503931
2020-03-30,86930721,883546442,169392,1238798,39430940,922977382
2020-03-31,78454990,885466463,66100,1221898,38379816,923846279
2020-04-01,72012676,864295611,65300,1190698,36887824,901183435
2020-04-02,74943636,873091218,226200,1167408,37683930,910775148
2020-04-03,67249453,866438797,109000,1047708,33002802,899441599
2020-04-07,97857146,897442015,68800,939908,30180446,927622461
2020-04-08,101770978,876801632,226823,973931,32577992,909379624
2020-04-09,94909680,863405259,171800,1007431,33950425,897355684
2020-04-10,85351712,843128432,166300,1073031,34336992,877465424
2020-04-13,41358337,834091383,69700,1034731,32180134,866271517
2020-04-14,62422331,839933143,55200,939131,29761062,869694205
2020-04-15,56324487,842809191,92900,900831,28150969,870960160
2020-04-16,35067757,837402391,65700,741031,23083115,860485506
2020-04-17,67618697,843677529,73500,720831,22511552,866189081
2020-04-20,54919123,856120933,150768,810599,25558186,881679119
2020-04-21,45555013,850409202,124376,703975,21879543,872288745
2020-04-22,35425042,847131756,132400,643907,19961117,867092873
2020-04-23,76110009,850373683,126120,645127,19024795,869398478
2020-04-24,34057298,854475176,121000,628807,18398893,872874069
2020-04-27,51019332,850406974,181500,657807,19510555,869917529
2020-04-28,46387722,833045551,159900,663607,19211423,852256974
2020-04-29,60186263,828374701,168336,682343,19303483,847678184
2020-04-30,63234677,821313741,154800,656407,19495288,840809029
2020-05-06,84090618,840362804,125700,617207,18818641,859181445
2020-05-07,79666602,853432702,124300,628007,19336335,872769037
2020-05-08,82712588,850456783,118800,641007,20153260,870610043
2020-05-11,73252878,867608086,128605,633812,20079164,887687250
2020-05-12,37705378,865474291,111800,612407,19217332,884691623
2020-05-13,28194525,861565538,64100,586107,18315844,879881382
2020-05-14,26083825,839168376,42900,585607,18060120,857228496
2020-05-15,33432782,819592331,49600,524907,16219627,835811958
2020-05-18,56432507,834513848,52800,538407,15979920,850493768
2020-05-19,28353680,826190650,94941,602948,18100499,844291149
2020-05-20,32153143,812359524,62300,602248,18224025,830583549
2020-05-21,30381813,795778605,34500,553848,16205593,811984198
2020-05-22,25372652,798707803,88600,569548,16357419,815065222
2020-05-25,39096684,800845161,44700,510048,13960014,814805175
2020-05-26,18323748,793681367,93000,550248,15599530,809280897
2020-05-27,12070556,789752113,65100,502748,13946229,803698342
2020-05-28,30598135,797854876,127518,580966,16023042,813877918
2020-05-29,21396633,789522837,64000,610866,16707185,806230022
2020-06-01,56763252,794280651,45200,565366,16435191,810715842
2020-06-02,42493031,782719642,100600,624066,18647092,801366734
2020-06-03,47467709,786159422,58027,599393,17772003,803931425
2020-06-04,29688464,794907209,8500,598993,17592424,812499633
2020-06-05,35283551,799010910,60400,646593,19236142,818247052
2020-06-08,49616631,789791873,53700,649193,19722483,809514356
2020-06-09,35043976,786107088,33100,568193,17267386,803374474
2020-06-10,36743615,799627390,31600,535793,16020211,815647601
2020-06-11,47522265,809307848,57400,541725,15986305,825294153
2020-06-12,43508535,805454409,28300,476525,13852582,819306991
2020-06-15,18304695,792577539,42800,454049,13199205,805776744
2020-06-16,71928543,755136541,23700,430584,13593537,768730078
2020-06-17,62601079,707772245,78900,463484,15160562,722932807
2020-06-18,105173295,710787296,93200,515984,17027472,727814768
2020-06-19,48289820,708501671,73000,449707,14579501,723081172
2020-06-22,41974436,721352812,28300,398307,12976842,734329654
2020-06-23,38945321,718540907,133700,496407,16158048,734698955
2020-06-24,46387177,699506944,43500,478007,15578249,715085193
2020-06-29,39346925,711840230,38300,470807,15127029,726967259
2020-06-30,80840770,722675074,41200,456107,14987676,737662750
2020-07-01,89779022,763614695,100297,537804,17317289,780931984
2020-07-02,55800739,748004797,41400,511923,16750121,764754918
2020-07-03,80982489,763593873,75559,503082,16792877,780386750
2020-07-06,211693215,880771009,124436,573818,19584409,900355418
2020-07-07,159522732,907960578,64197,595315,20657430,928618008
2020-07-08,140097391,923666084,40900,548615,19519721,943185805
2020-07-09,171478176,954388269,106600,638815,22844024,977232293
2020-07-10,108328856,942430942,57100,690715,24257911,966688853
2020-07-13,154582233,968723083,43000,662315,24538771,993261854
2020-07-14,148864388,956630880,81454,633269,22854678,979485558
2020-07-15,86156679,942405313,110300,702269,25211457,967616770
2020-07-16,78723161,935886945,104200,738872,25638858,961525803
2020-07-17,56368859,921162143,97400,778772,27903401,949065544
2020-07-20,110794981,959478440,92900,823672,29833400,989311840
2020-07-21,59796442,951897742,88900,903472,32624374,984522116
2020-07-22,83889845,971411809,27900,888957,32224692,1003636501
2020-07-23,94125670,966900342,33700,860157,30277527,997177869
2020-07-24,68480410,911946405,55300,891157,28606140,940552545
2020-07-27,27520339,916908766,49900,848221,27032803,943941569
2020-07-28,25214266,918680869,33900,714621,22860726,941541595
2020-07-29,23203920,909648309,10600,682921,22331516,931979825
2020-07-30,29770167,899161190,28200,616821,19806122,918967312
2020-07-31,42018529,904699234,23000,532121,17187509,921886743
2020-08-03,59350368,914307007,40200,554021,18371337,932678344
2020-08-04,111002881,970953603,87000,629421,20972307,991925910
2020-08-05,34244172,955783582,12700,638221,21227230,977010812
2020-08-06,53239412,939886291,33000,601721,19501777,959388068
2020-08-07,29276664,920467093,65900,634121,20203095,940670188
2020-08-10,59477396,943494869,15800,586921,18517357,962012226
2020-08-11,49297088,966237359,51100,620921,19416200,985653559
2020-08-12,27163895,946915809,30686,626007,19318576,966234385
2020-08-13,23169862,933980146,42200,639357,20031056,954011202
2020-08-14,38917858,945485355,12500,601657,19006346,964491701
2020-08-17,55694540,965715238,29700,603957,19308505,985023743
2020-08-18,37547724,967143349,81517,651174,20511983,987655332
2020-08-19,29800135,954985142,9900,633874,19434578,974419720
2020-08-20,28626810,948877483,17400,601874,18176595,967054078
2020-08-21,21182492,937358047,31291,617965,18866471,956224518
2020-08-24,42307730,950005828,44500,634365,19728751,969734579
2020-08-25,96433180,978369751,63400,683265,22103624,1000473375
2020-08-26,309748359,1177260594,62300,733465,23991640,1201252234
2020-08-27,130047771,1192323572,86200,767765,25528188,1217851760
2020-08-28,62700256,1185645242,36977,787942,26104518,1211749760
2020-08-31,78435131,1143535778,30100,776142,25472982,1169008760
2020-09-01,57078146,1140252024,23300,770942,25841976,1166094000
2020-09-02,63505519,1112091455,96374,841086,28916538,1141007993
2020-09-03,42848665,1098750259,38800,819786,28217035,1126967294
2020-09-04,47598120,1110059183,42300,793811,27124522,1137183705
2020-09-07,45647982,1078564159,62400,809411,26888634,1105452793
2020-09-08,30005072,1074221978,30600,799621,26971217,1101193195
2020-09-09,50859747,1074582548,39100,754915,24919744,1099502292
2020-09-10,48098757,1067712343,78000,732421,23613254,1091325597
2020-09-11,46147763,1077300751,83800,761421,24266488,1101567239
2020-09-14,31938946,1065962992,82700,766621,24746604,1090709596
2020-09-15,31045779,1049701480,60900,747221,24740488,1074441968
2020-09-16,41647695,1058302997,69139,787460,26403533,1084706530
2020-09-17,66106832,1069683571,39400,762969,25940946,1095624517
2020-09-18,42826489,1064821386,28900,736169,25213790,1090035176
2020-09-21,49048380,1070501783,33500,767569,26166428,1096668211
2020-09-22,59353748,1054657182,43391,738060,25736153,1080393335
2020-09-23,37016681,1055384976,65143,784103,27420084,1082805060
2020-09-24,32875387,1053177778,70200,807903,28171578,1081349356
2020-09-25,30957641,1041923809,57000,828803,28369927,1070293736
2020-09-28,28842748,1035574997,19200,810245,27224232,1062799229
2020-09-29,54116638,1043175767,39600,772645,27119839,1070295606
2020-09-30,37575205,1040904374,53300,807045,28222365,1069126739
2020-10-09,73527229,1057484081,46600,827370,29082055,1086566136
2020-10-12,132489247,1110896482,29500,851370,31032437,1141928919
2020-10-13,96707761,1156467841,98900,922270,33247833,1189715674
2020-10-14,69208579,1154433136,90100,950170,33236947,1187670083
2020-10-15,35856009,1138960294,37900,987070,34034174,1172994468
2020-10-16,65085945,1125082771,44800,920870,30711015,1155793786
2020-10-19,144987780,1118715107,110500,988970,34020568,1152735675
2020-10-20,114426026,1172419329,17000,931270,30908851,1203328180
2020-10-21,80272118,1122413247,74000,972770,31235646,1153648893
2020-10-22,52874243,1105418589,64700,1029270,33368934,1138787523
2020-10-23,48198069,1099572553,52600,1039070,32876176,1132448729
2020-10-26,40678716,1106848371,33700,1028670,33102601,1139950972
2020-10-27,24777614,1084991485,66500,1047571,34108913,1119100398
2020-10-28,51017967,1089594030,62800,1098271,35133691,1124727721
2020-10-29,29750050,1069279312,15700,1046071,33202294,1102481606
2020-10-30,45810346,1058004234,61300,1098571,34495130,1092499364
2020-11-02,42149229,1042328344,6400,1012855,31125035,1073453379
2020-11-03,39567938,1045793451,51900,1038655,33018843,1078812294
2020-11-04,42555897,1061826562,23300,1037655,32239941,1094066503
2020-11-05,94798447,1060600089,2800,872755,28766005,1089366094
2020-11-06,51711997,1028563221,10200,871455,28444292,1057007513
2020-11-09,112743958,1059402415,55698,909353,30417858,1089820273
2020-11-10,53999657,1065709368,73000,956753,31333663,1097043031
2020-11-11,48199666,1068922207,24763,938273,29743254,1098665461
2020-11-12,29495414,1063813513,36900,906573,28729299,1092542812
2020-11-13,29660670,1060909253,21600,904673,28949536,1089858789
2020-11-16,43635945,1074687602,78200,977473,31445306,1106132908
2020-11-17,52049661,1080879369,53246,1010919,31571000,1112450369
2020-11-18,19439349,1070663313,44900,999658,31309288,1101972601
2020-11-19,37093234,1081740806,8200,965458,30209181,1111949987
2020-11-20,35343685,1068848214,20500,939458,29217142,1098065356
2020-11-23,30552466,1053089478,8600,869758,27092961,1080182439
2020-11-24,49495083,1049542736,34700,879767,27536708,1077079444
2020-11-25,61497876,1056363499,15900,863367,27282397,1083645896
2020-11-26,28999811,1056285599,55100,901567,28047751,1084333350
2020-11-27,27001223,1046711014,1500,867867,26765018,1073476032
2020-11-30,22560727,1032146688,12900,834367,25615066,1057761754
2020-12-01,21470760,1028256052,4700,741417,22946857,1051202909
2020-12-02,43632375,1030756973,19300,640517,20150665,1050907638
2020-12-03,27868019,1033547209,13500,489234,15254316,1048801525
2020-12-04,33398352,1019483134,7900,424819,13649434,1033132568
2020-12-07,29447442,1022572914,22600,414696,13145863,1035718777
2020-12-08,26568718,1016253670,24800,384096,12172002,1028425672
2020-12-09,29917176,1007660383,65700,425596,13108357,1020768740
2020-12-10,15665109,1000733617,61900,484696,14972259,1015705876
2020-12-11,48625459,977603352,69200,537596,15670923,993274275
2020-12-14,18010539,979039276,32500,519696,15185518,994224794
2020-12-15,11970385,972952841,37500,526896,15569777,988522618
2020-12-16,8438339,970205182,27000,544396,15890920,986096102
2020-12-17,17818225,973524064,5700,521696,15363947,988888011
2020-12-18,9323655,965174122,88700,601496,17708042,982882164
2020-12-21,21749602,966476335,29896,555192,16511411,982987746
2020-12-22,15787929,957148515,98591,625383,18192392,975340907
2020-12-23,23455577,948298704,62300,634083,18388407,966687111
2020-12-24,22222498,944655002,77500,682983,19260120,963915122
2020-12-25,15095600,942868995,83500,733583,20775070,963644065
2020-12-28,23497229,942948465,152446,855929,23272709,966221174
2020-12-29,31759082,935572166,105700,895729,25832824,961404990
2020-12-30,29941799,934429937,77293,859022,24851506,959281443
2020-12-31,25963294,929326563,93400,900422,26148256,955474819
2021-01-04,30601506,932718386,72000,948822,27933319,960651705
2021-01-05,44215733,945443484,107900,1007972,29815813,975259297
2021-01-06,29639044,943863821,42070,919751,26562409,970426230
2021-01-07,18666498,933305624,56205,890756,25208397,958514021
2021-01-08,27960441,932063465,225900,1040556,30176124,962239589
2021-01-11,31684124,937896014,107800,1041956,30070850,967966864
2021-01-12,23309846,941446700,37900,909750,26628382,968075082
2021-01-13,61542984,960003312,133400,980050,29509306,989512618
2021-01-14,43936829,953485672,33200,1001650,30029468,983515140
2021-01-15,25152496,948551377,19600,965750,28450996,977002373
2021-01-18,30927562,952988586,55600,983750,29561688,982550274
2021-01-19,27049054,954242982,3700,926624,27363206,981606188
2021-01-20,19124889,950091018,19700,848424,25147287,975238305
2021-01-21,28868631,942909525,52900,838288,24637285,967546810
2021-01-22,23388685,926313044,64369,886357,25287764,951600808
2021-01-25,23016513,923238958,48500,877257,24510560,947749518
2021-01-26,18759880,923282527,90200,954157,26382440,949664967
2021-01-27,19186556,913549767,30700,977657,27149535,940699302
2021-01-28,13266173,902721997,21700,997557,27033794,929755791
2021-01-29,21853861,889427118,64900,1023357,26484479,915911597
2021-02-01,14881328,890378277,14100,967327,24976384,915354661
2021-02-02,11670864,879002551,44000,970627,25449840,904452391
2021-02-03,22565290,856629041,40000,980727,24027813,880656854
2021-02-04,16887604,827152920,9400,885658,21353215,848506135
2021-02-05,13031080,819854562,71300,909258,21067508,840922070
2021-02-08,10318224,822969249,34600,915758,21227271,844196520
2021-02-09,19134496,823957314,41100,954058,22372659,846329973
2021-02-10,17362885,813172067,11400,934258,22291396,835463463
2021-02-18,26561553,821007581,35600,963858,23441027,844448608
2021-02-19,25037153,830031978,17000,974158,24178602,854210580
2021-02-22,40317226,840553500,57300,1023058,24952385,865505885
2021-02-23,20194201,844277082,12800,1008858,24676667,868953749
2021-02-24,24143883,851961833,46600,1048258,25692804,877654637
2021-02-25,15570102,844433457,32100,1075658,26116976,870550433
2021-02-26,18698447,842857270,27300,1092258,26672939,869530209
2021-03-01,26037624,842744610,59400,1109458,27403613,870148223
2021-03-02,29020401,849606573,31800,1137258,27692234,877298807
2021-03-03,23645651,853356124,18700,1105458,27337977,880694101
2021-03-04,13689815,844123640,46800,1109458,27037491,871161131
2021-03-05,19031468,850041655,84900,1185558,28998749,879040404
2021-03-08,29022176,855050042,31100,1161158,28007131,883057173
2021-03-09,30692979,837055648,46100,1156258,26455183,863510831
2021-03-10,19535844,828330708,4600,990558,21891332,850222040
2021-03-11,10756737,804922339,7700,921647,20792357,825714696
2021-03-12,10284334,799054806,45647,949754,21435949,820490755
2021-03-15,14434766,797066753,30200,928454,20323858,817390611
2021-03-16,11797357,792195935,63000,961954,20951358,813147293
2021-03-17,11769516,787887681,15100,952654,21044126,808931807
2021-03-18,9678684,787513142,24900,962654,21062869,808576011
2021-03-19,9054965,777175018,17800,967254,21182864,798357882
2021-03-22,9791515,773854450,28600,990054,22018801,795873251
2021-03-23,9564433,772631148,45400,1016654,22417222,795048370
2021-03-24,8306617,771552051,41400,1035554,22523301,794075352
2021-03-25,13125502,778477212,31600,1028454,22492289,800969501
2021-03-26,17704966,784416759,104900,1089054,24318577,808735336
2021-03-29,11485138,782699956,85300,1124354,24926929,807626885
2021-03-30,9194004,777844284,12800,1122154,24833268,802677552
2021-03-31,8160346,775768297,19000,1086654,24145452,799913749
2021-04-01,12803925,775587104,93900,1154654,26002808,801589912
2021-04-02,21876656,774820307,83400,1182954,27207942,802028249
2021-04-06,17338373,781079347,80300,1261554,28738200,809817547
2021-04-07,26964350,790397849,16500,1266354,28796892,819194741
2021-04-08,17204559,791097501,5500,1254054,28040648,819138149
2021-04-09,10808154,789359267,7100,1251954,27668183,817027450
2021-04-12,13013477,790603005,25100,1224354,26580727,817183732
2021-04-13,8230274,785301265,18400,1222054,26469689,811770954
2021-04-14,30084112,786170666,63800,1242884,27728744,813899410
2021-04-15,47495859,793331644,45415,1160049,26831934,820163578
2021-04-16,25202799,779825995,116500,1180949,27551541,807377536
2021-04-19,37910412,787173856,48400,1222049,28754812,815928668
2021-04-20,20996149,783696470,21800,1199249,27822577,811519047
2021-04-21,15913452,784781566,18700,1041949,24110700,808892266
2021-04-22,29360001,793925178,4100,961749,22476074,816401252
2021-04-23,22655427,782116895,64270,1007819,23572886,805689781
2021-04-26,22734131,783943410,17200,1019619,23390059,807333469
2021-04-27,23897044,789293856,42900,1049719,24269504,813563360
2021-04-28,14048670,784488878,10900,964119,22068684,806557562
2021-04-29,11707988,781464180,5000,935919,21413826,802878006
2021-04-30,11913583,768902725,40500,960919,21361229,790263954
2021-05-06,9263057,764214865,21400,888592,20019977,784234842
2021-05-07,7026508,755598259,33900,914692,20534835,776133094
2021-05-10,12578227,753974280,77100,990892,21601445,775575725
2021-05-11,9962915,751645448,30800,1003792,22143653,773789101
2021-05-12,4808228,747693742,24600,991492,22001207,769694949
2021-05-13,7817516,741301911,35000,957374,21665374,762967285
2021-05-14,11014572,737554704,39200,992074,22688732,760243436
2021-05-17,14213151,738193002,59834,1039008,23782894,761975896
2021-05-18,14145323,736900564,18500,980508,22816420,759716984
2021-05-19,8010377,731879722,10500,987408,22848621,754728343
2021-05-20,12687203,732907407,2700,971108,22626818,755534225
2021-05-21,6265750,725931896,33635,1004243,23037333,748969229
2021-05-24,24810658,731223641,5800,950543,22185675,753409316
2021-05-25,22305440,726250569,22600,957243,22629224,748879793
2021-05-26,21816898,727311021,44000,933943,21891625,749202646
2021-05-27,42987968,742541956,8100,867343,20720825,763262781
2021-05-28,20875023,731458163,62700,923243,22185528,753643691
2021-05-31,37114033,736133077,44500,927443,22944940,759078017
2021-06-01,26407594,732166143,96400,1018143,24995412,757161555
2021-06-02,35999228,734322900,2300,868947,21306579,755629479
2021-06-03,37006952,748359382,7600,819447,20035478,768394860
2021-06-04,16689152,730022601,11800,701742,17017243,747039844
2021-06-07,16001027,717931549,44100,591298,14664190,732595739
2021-06-08,17787462,716700913,56200,578383,14193518,730894431
2021-06-09,17898375,711469887,8600,447756,10777487,722247374
2021-06-10,13365182,712611612,9900,435656,10569014,723180626
2021-06-11,14134068,708072342,26500,461156,10915562,718987904
2021-06-15,9342123,700749795,5700,454956,10841601,711591396
2021-06-16,28129989,705879459,107100,511856,12535354,718414813
2021-06-17,40789792,717833242,106000,589856,14764095,732597337
2021-06-18,36094905,730105640,67500,633056,15712450,745818090
2021-06-21,35242293,736252260,30100,654156,16157653,752409913
2021-06-22,37711010,738876052,62500,671956,16207579,755083631
2021-06-23,45163857,726411590,61100,647456,16413009,742824599
2021-06-24,44013764,741417787,91393,726264,18497945,759915732
2021-06-25,55069650,743723541,212700,903564,22552957,766276498
2021-06-28,43446500,751308597,88100,960664,24006993,775315590
2021-06-29,33165720,757501986,86387,1024651,25062964,782564950
2021-06-30,23390137,757168996,60300,1045351,25715634,782884630
2021-07-01,38371055,752158996,30500,1057051,24956973,777115969
2021-07-02,17388894,746597942,39000,1081151,25439482,772037424
2021-07-05,25726656,749463447,12400,1049251,24269176,773732623
2021-07-06,15704256,739649319,26200,1046551,24259052,763908371
2021-07-07,21228497,734280653,53600,1057151,24906478,759187131
2021-07-08,27209006,733604368,40500,1078351,25233414,758837782
2021-07-09,28062134,730545073,40900,1106851,25977794,756522867
2021-07-12,93613200,764768352,42900,1089451,27051068,791819420
2021-07-13,41250638,737422778,78700,912788,22874467,760297245
2021-07-14,28300515,731998706,14600,880188,21793455,753792161
2021-07-15,34330981,735513222,26600,853088,21327200,756840422
2021-07-16,34248295,740886855,66300,889788,21657440,762544295
2021-07-19,48445260,749671508,92900,960888,24051027,773722535
2021-07-20,44565099,768713003,53300,976788,24585754,793298757
2021-07-21,41728094,773795091,77100,1026088,25549591,799344682
2021-07-22,37138296,756514602,27900,1004388,24948998,781463600
2021-07-23,85237959,763694460,50900,1013188,25866689,789561149
2021-07-26,61889409,776984412,42300,1036488,25642713,802627125
2021-07-27,77929718,758174023,20600,963088,24857301,783031324
2021-07-28,114234791,776667649,255400,1189373,32350945,809018594
2021-07-29,143350690,794115997,196700,1327373,36874422,830990419
2021-07-30,129861637,816179342,243200,1527373,41880568,858059910
2021-08-02,122384770,841552575,78646,1540819,43928749,885481324
2021-08-03,112739115,850773811,226600,1690673,47220497,897994308
2021-08-04,87896992,856980000,127800,1488484,41454279,898434279
2021-08-05,64320029,863466650,122700,1466884,39767225,903233875
2021-08-06,51758911,840781060,66831,1434915,38886196,879667256
2021-08-09,85835798,868449979,171187,1549371,42700665,911150644
2021-08-10,66732253,882273084,176390,1663329,45059583,927332667
2021-08-11,45997240,877382694,69300,1486329,39729576,917112270
2021-08-12,85283526,880202982,237900,1653429,45833053,926036035
2021-08-13,91462496,867838725,148100,1658529,44647601,912486326
2021-08-16,76349021,874799785,116800,1601729,41100365,915900150
2021-08-17,44807551,883100148,153044,1634473,41025272,924125420
2021-08-18,38368135,876707246,119900,1652673,41217665,917924911
2021-08-19,34642096,868295338,96718,1648409,42116851,910412189
2021-08-20,22019226,862693032,171139,1728369,43520331,906213363
2021-08-23,42147427,863560067,178700,1752718,45342815,908902882
2021-08-24,29041610,858445798,95800,1709055,44213253,902659051
2021-08-25,55769296,868706385,235917,1750935,44911484,913617869
2021-08-26,94135134,849476733,222200,1805018,43302381,892779114
2021-08-27,31027814,844036570,251834,1887352,45560677,889597247
2021-08-30,33338604,845896011,145100,1872744,45226768,891122779
2021-08-31,44844037,851018471,105500,1766044,41978865,892997336
2021-09-01,35122354,849703925,157390,1733360,41028631,890732556
2021-09-02,24694189,852126134,127300,1717177,40199114,892325248
2021-09-03,32313237,851211977,128400,1769377,41987317,893199294
2021-09-06,27613524,847942481,155000,1808577,43460105,891402586
2021-09-07,35331915,850939455,138200,1814677,43570395,894509850
2021-09-08,33588082,852557286,205800,1958987,47603384,900160670
2021-09-09,28630533,854612940,164815,1946002,46684588,901297528
2021-09-10,37248223,852238787,296700,2039287,48596208,900834995
2021-09-13,21439935,840775141,149390,2017677,47274172,888049313
2021-09-14,13685553,827010823,231220,2034697,47876419,874887242
2021-09-15,13907634,819588833,163600,1983397,46272652,865861485
2021-09-16,16300596,810900257,190811,1993108,46718451,857618708
2021-09-17,27540697,803096040,204200,1967698,45434147,848530187
2021-09-22,10090311,801714340,121808,1930932,44199033,845913373
2021-09-23,23021988,805951310,251800,2041232,47499467,853450777
2021-09-24,16776594,805888987,95052,1942884,44900050,850789037
2021-09-27,18446650,803825525,157300,1999358,46645023,850470548
2021-09-28,15184537,806069233,52500,1829558,42061538,848130771
2021-09-29,16251579,802916670,156400,1852471,41310103,844226773
2021-09-30,10383123,798627645,17700,1766160,39561984,838189629
2021-10-08,15077199,797411861,80000,1756160,40286310,837698171
2021-10-11,19380514,799073727,67800,1732760,40252015,839325742
2021-10-12,8579362,795061428,104700,1769260,40692980,835754408
2021-10-13,10878373,792802000,170400,1845383,42886701,835688701
2021-10-14,8298414,789807866,106200,1863629,42900739,832708605
2021-10-15,14842170,789539858,46900,1821029,42156822,831696680
2021-10-18,9703781,787668134,24895,1809224,41720706,829388840
2021-10-19,6791101,775747168,42600,1824824,42135186,817882354
2021-10-20,12837177,774896011,83961,1891285,43348252,818244263
2021-10-21,18253946,771660775,55438,1906723,42805931,814466706
2021-10-22,8258738,770369570,36400,1920923,43278396,813647966
2021-10-25,8636666,769713379,40800,1942823,43635805,813349184
2021-10-26,24319568,774516887,72077,1994700,45060272,819577159
2021-10-27,37306549,777918303,92200,1963623,42335713,820254016
2021-10-28,8088469,770158279,18600,1895523,40696878,810855157
2021-10-29,6271071,766998590,66598,1937221,42018323,809016913
2021-11-01,11369740,766576023,79900,1880480,41370560,807946583
2021-11-02,10803662,757081140,70600,1854880,40844457,797925597
2021-11-03,4239348,749668825,19500,1765280,38959729,788628554
2021-11-04,15125080,751340692,64800,1776956,39643889,790984581
2021-11-05,7726824,743535328,68900,1748310,39336977,782872305
2021-11-08,8698387,743551960,239600,1929410,42697842,786249802
2021-11-09,8727082,742130839,362900,2273710,50749206,792880045
2021-11-10,8259491,741694111,41800,2214410,49359199,791053310
2021-11-11,15668891,737319521,51700,2155710,48977732,786297253
2021-11-12,29650291,745703560,65900,2153256,49890942,795594502
2021-11-15,28002487,745993729,116200,2164956,50508424,796502153
2021-11-16,25776522,757129079,232622,2044778,46539146,803668225
2021-11-17,25154606,754952298,103217,2022995,47803372,802755670
2021-11-18,30389683,765988709,188700,2106295,49076673,815065382
2021-11-19,19945347,763177613,68800,2020795,46963277,810140890
2021-11-22,37011674,774426100,114200,2023695,47455647,821881747
2021-11-23,29696917,772526577,108231,2002726,47384497,819911074
2021-11-24,49454248,783826926,265284,2031410,49282007,833108933
2021-11-25,40200205,777680141,147600,2047710,49042654,826722795
2021-11-26,29722126,769614267,251867,2048877,48005188,817619455
2021-11-29,20886775,777480204,30600,1907182,44246622,821726826
2021-11-30,22910529,778646037,137900,1931982,45015180,823661217
2021-12-01,21133381,771251683,126200,1728871,41008821,812260504
2021-12-02,25498425,767941151,77600,1506771,35183103,803124254
2021-12-03,21257589,768013719,148424,1502208,35076557,803090276
2021-12-06,29459853,768601038,104100,1282718,29092045,797693083
2021-12-07,21756961,770891065,232400,1363395,30471879,801362944
2021-12-08,16202323,773510200,177900,1398795,31612767,805122967
2021-12-09,26382556,780273100,87400,1356219,30962480,811235580
2021-12-10,13920053,782690085,118700,1369919,31097162,813787247
2021-12-13,17513743,785708519,94300,1349619,30784809,816493328
2021-12-14,13626687,776024379,128500,1376419,31919158,807943537
2021-12-15,19823284,773694203,114896,1327615,30628078,804322281
2021-12-16,10863080,773323325,79400,1365715,31534360,804857685
2021-12-17,17335369,764208120,184547,1434762,32267798,796475918
2021-12-20,9219528,761486139,41496,1380758,30597598,792083737
2021-12-21,15721572,766681210,290000,1648358,36807833,803489043
2021-12-22,15000477,768016190,369100,2010158,45067742,813083932
2021-12-23,13530238,768042825,96900,2030989,44986406,813029231
2021-12-24,16329843,767913388,123686,2126675,46850650,814764038
2021-12-27,19035113,769096332,34600,2141975,47744622,816840954
2021-12-28,23704209,764870555,47700,2132675,47942535,812813090
2021-12-29,29790280,753168032,49200,2028675,47024686,800192718
2021-12-30,18214865,743078097,33200,2027275,47093599,790171696
2021-12-31,15370517,735156699,23400,1888975,43994227,779150926
2022-01-04,24081983,738936638,32300,1869775,43864922,782801560
2022-01-05,15599653,736841858,127500,1970775,45505195,782347053
2022-01-06,17705799,743420906,94000,2058075,47273983,790694889
2022-01-07,23639021,747055672,35500,2080387,46933530,793989202
2022-01-10,18627137,744158905,57700,2129287,49271700,793430605
2022-01-11,12364313,739144603,24600,2139987,48920104,788064707
2022-01-12,19484649,742923604,6600,2121287,48344131,791267735
2022-01-13,27797270,751278783,26100,2087187,47274785,798553568
2022-01-14,12334650,747745841,51200,2109487,47041561,794787402
2022-01-17,29864414,720576122,35700,2117487,49570371,770146493
2022-01-18,20185202,713599644,72600,2094287,48671231,762270875
2022-01-19,35127734,730380702,92400,2132987,49954555,780335257
2022-01-20,17645903,727838077,159100,2253387,51895503,779733580
2022-01-21,13230922,722573462,39700,2197787,49977677,772551139
2022-01-24,16938148,723042469,17700,2181687,48498903,771541372
2022-01-25,33704557,723693642,205962,2366849,48875431,772569073
2022-01-26,15785008,725005064,61700,2404349,49000632,774005696
2022-01-27,10351527,722086814,93100,2436949,48690242,770777056
2022-01-28,3683296,713165932,76070,2285319,45729233,758895165
2022-02-07,7709792,714901895,114500,2392119,48320804,763222699
2022-02-08,5805533,714787436,4000,2341187,47853863,762641299
2022-02-09,14385417,718228342,101700,2427518,50540926,768769268
2022-02-10,6364387,714280860,10400,2291418,47432352,761713212
2022-02-11,5040374,708692209,86000,2362318,48451142,757143351
2022-02-14,3144369,704723563,37300,2384157,48684485,753408048
2022-02-15,8353013,708022937,33000,2400957,49339666,757362603
2022-02-16,5548184,706983699,15900,2412457,49527743,756511442
2022-02-17,5015822,705602374,52700,2439557,49742567,755344941
2022-02-18,25832327,711201591,36400,2065757,43463527,754665118
2022-02-21,57843241,728387665,99100,2143868,47936889,776324554
2022-02-22,24841962,720710556,142100,2215168,49442551,770153107
2022-02-23,16459831,714076398,268200,2180568,49455281,763531679
2022-02-24,25804185,713603889,143700,2189268,47682258,761286147
2022-02-25,15707515,711252788,118600,2225268,48177052,759429840
2022-02-28,12760877,713137809,28200,2171768,46953624,760091433
2022-03-01,11151759,713667563,77055,2238823,48761566,762429129
2022-03-02,7267538,710494107,47200,2276823,49657509,760151616
2022-03-03,10155993,711079423,7200,2161323,46295538,757374961
2022-03-04,7871636,709550261,34000,2066223,43865915,753416176
2022-03-07,17153207,713818247,53300,2057223,41967349,755785596
2022-03-08,14204854,714250857,109200,2067623,41311107,755561964
2022-03-09,18249980,712679899,141100,2151523,41739546,754419445
2022-03-10,12788512,714300016,101900,2187723,42354318,756654334
2022-03-11,11187977,711701788,26300,2172423,42275351,753977139
2022-03-14,6318518,712678450,41300,2193723,41724612,754403062
