日期,融资买入额(元),融资余额(元),融券卖出量,融券余量,融券余额(元),融资融券余额(元)
2017-07-12,8141222,708062927,0,5000,15300,708078227
2017-07-13,8685444,704108349,0,5000,15300,704123649
2017-07-14,6585983,694928870,0,5000,15200,694944070
2017-07-17,85457783,683102710,353000,358000,1167080,684269790
2017-07-18,52377397,659329603,0,318000,1055760,660385363
2017-07-19,35796410,648175693,0,5000,16450,648192143
2017-07-20,31407489,654453911,0,5000,16400,654470311
2017-07-21,35004159,640809924,60000,65000,215150,641025074
2017-07-24,43593587,643114196,0,65000,218400,643332596
2017-07-25,16307404,637937845,0,65000,215150,638152995
2017-07-26,21457134,642039676,0,5000,16450,642056126
2017-07-27,34764727,655837325,0,5000,16500,655853825
2017-07-28,20477263,658192727,0,5000,16250,658208977
2017-07-31,29559407,638248993,0,5000,16350,638265343
2017-08-01,43343898,642045921,60000,65000,215800,642261721
2017-08-02,36530432,630559776,0,5000,16250,630576026
2017-08-03,40175300,647486316,0,5000,16250,647502566
2017-08-04,21084877,638860471,0,5000,16150,638876621
2017-08-07,26398563,642665635,60000,65000,212550,642878185
2017-08-08,40019749,644321109,0,5000,16450,644337559
2017-08-09,18709241,640377465,0,5000,16300,640393765
2017-08-10,13392224,634713146,0,5000,16100,634729246
2017-08-11,43948593,648883877,0,5000,15600,648899477
2017-08-14,26399648,647744317,135900,140900,449471,648193788
2017-08-15,10041615,645971035,0,5000,15900,645986935
2017-08-16,13703722,637883296,0,5000,16100,637899396
2017-08-17,12785935,634445854,0,5000,16250,634462104
2017-08-18,11639258,632127174,0,5000,16150,632143324
2017-08-21,14117823,628877719,0,5000,16250,628893969
2017-08-22,21115734,629177263,0,5000,16150,629193413
2017-08-23,16078731,626055594,0,5000,16050,626071644
2017-08-24,13971359,620516748,0,5000,16000,620532748
2017-08-25,23935844,627388550,0,5000,16100,627404650
2017-08-28,31343634,636882817,0,5000,16250,636899067
2017-08-29,20598636,636986510,0,5000,16100,637002610
2017-08-30,14523505,632555192,0,5000,16100,632571292
2017-08-31,11422660,628529487,0,5000,16100,628545587
2017-09-01,18705911,630790482,0,5000,16050,630806532
2017-09-04,20188496,635219815,10000,15000,48450,635268265
2017-09-05,17063729,638139618,0,15000,48150,638187768
2017-09-06,55646396,627447914,0,5000,16500,627464414
2017-09-07,34080770,621898151,0,5000,16200,621914351
2017-09-08,14896903,619623861,0,5000,16250,619640111
2017-09-11,22703216,624872310,0,5000,16250,624888560
2017-09-12,29496883,628713938,0,5000,16100,628730038
2017-09-13,18125382,624209769,30000,35000,113750,624323519
2017-09-14,25108299,618704675,119500,124500,407115,619111790
2017-09-15,23541024,621132956,0,5000,16150,621149106
2017-09-18,22693253,626420844,0,5000,16300,626437144
2017-09-19,21748806,627376827,0,5000,16400,627393227
2017-09-20,90111157,632933399,154100,159100,548895,633482294
2017-09-21,64608096,639797507,0,55000,187000,639984507
2017-09-22,50970970,643960138,0,5000,16750,643976888
2017-09-25,55377342,653072325,34600,39600,135432,653207757
2017-09-26,21136033,654544738,0,5000,16950,654561688
2017-09-27,25154095,658297844,0,5000,17100,658314944
2017-09-28,24590632,653549406,0,5000,17100,653566506
2017-09-29,18570363,639818633,0,5000,17000,639835633
2017-10-09,110406447,669745081,119500,124500,448200,670193281
2017-10-10,83289600,695801989,0,5000,18000,695819989
2017-10-11,71855130,687254069,121800,126800,451408,687705477
2017-10-12,34142429,687272618,0,7300,26280,687298898
2017-10-13,30310298,678741362,37000,42000,151620,678892982
2017-10-16,56403489,660990037,0,42000,144900,661134937
2017-10-17,17072122,662097042,2600,44600,155208,662252250
2017-10-18,83961642,662859196,119500,164100,595683,663454879
2017-10-19,35248591,646307895,0,44600,158330,646466225
2017-10-20,36259937,652375770,0,44600,161006,652536776
2017-10-23,44073932,660092181,0,42000,154140,660246321
2017-10-24,31863474,661539322,0,42000,154140,661693462
2017-10-25,64110848,678104167,119500,161500,607240,678711407
2017-10-26,67928970,672145863,0,161500,597550,672743413
2017-10-27,43893969,666694357,0,42000,153720,666848077
2017-10-30,47064559,674179298,0,42000,147000,674326298
2017-10-31,26748827,671312392,0,42000,149520,671461912
2017-11-01,20998224,665440126,50000,92000,323840,665763966
2017-11-02,32710386,665720611,0,67000,228470,665949081
2017-11-03,27399240,668912838,0,42000,142800,669055638
2017-11-06,32859629,658343255,25000,67000,235170,658578425
2017-11-07,24797814,664440569,0,42000,147840,664588409
2017-11-08,24619470,655718833,0,42000,145320,655864153
2017-11-09,40816881,652010030,119500,161500,570095,652580125
2017-11-10,73145637,649680754,1000,43000,155660,649836414
2017-11-13,60719335,648992913,119500,161500,600780,649593693
2017-11-14,41987397,649127739,0,161500,589475,649717214
2017-11-15,91085871,663921876,0,42000,160020,664081896
2017-11-16,81401891,659269771,60000,102000,386580,659656351
2017-11-17,76926149,663155298,6900,48900,175062,663330360
2017-11-20,38805722,650602911,0,43000,158240,650761151
2017-11-21,74451350,641843475,119500,162500,624000,642467475
2017-11-22,59002205,650133443,0,111500,423700,650557143
2017-11-23,67331117,635369067,50000,92000,346840,635715907
2017-11-24,86493176,643623632,72100,114100,447272,644070904
2017-11-27,86180760,629251684,0,112100,421496,629673180
2017-11-28,103346152,651772410,52000,163500,640920,652413330
2017-11-29,60638627,632114640,0,111500,431505,632546145
2017-11-30,75749278,645453455,50000,161500,628235,646081690
2017-12-01,103062487,618823586,1000,162500,650000,619473586
2017-12-04,71351145,629884257,0,162500,651625,630535882
2017-12-05,89078535,651001933,0,161500,623390,651625323
2017-12-06,101555777,667203369,0,161500,657305,667860674
2017-12-07,68830234,665717308,0,161500,647615,666364923
2017-12-08,61643529,659871956,0,42000,167160,660039116
2017-12-11,52594317,650567671,0,42000,167580,650735251
2017-12-12,54076547,662400699,0,42000,164640,662565339
2017-12-13,42893540,668482789,0,42000,165900,668648689
2017-12-14,53846407,659292507,74500,116500,461340,659753847
2017-12-15,48667886,667256726,0,42000,160860,667417586
2017-12-18,37285167,662474707,0,42000,157080,662631787
2017-12-19,19354641,661859270,0,42000,158340,662017610
2017-12-20,31564764,670105863,0,42000,158340,670264203
2017-12-21,35741160,665444953,59500,101500,388745,665833698
2017-12-22,16261576,659923529,0,101500,387730,660311259
2017-12-25,22342137,661998358,0,101500,378595,662376953
2017-12-26,46907702,670729993,2600,104100,378924,671108917
2017-12-27,30447762,677728788,0,104100,375801,678104589
2017-12-28,30547149,665879693,0,104100,365391,666245084
2017-12-29,19669029,662473249,0,42000,150360,662623609
2018-01-02,17232906,668987152,0,42000,151620,669138772
2018-01-03,27922776,669636739,0,42000,152460,669789199
2018-01-04,36293680,688101768,0,42000,152460,688254228
2018-01-05,24098908,678648659,0,42000,149520,678798179
2018-01-08,25699318,680063864,0,42000,150780,680214644
2018-01-09,15930089,680682003,0,42000,149520,680831523
2018-01-10,20845502,679651599,0,42000,146160,679797759
2018-01-11,26777483,676893889,2600,44600,161006,677054895
2018-01-12,15877589,674540989,15000,57000,201780,674742769
2018-01-15,25496813,683666262,0,57000,196650,683862912
2018-01-16,21323555,684929984,0,57000,194940,685124924
2018-01-17,22417553,684970771,0,57000,196080,685166851
2018-01-18,12553973,687243309,0,20000,68200,687311509
2018-01-19,20305810,687906431,0,20000,67200,687973631
2018-01-22,22168673,689220197,0,20000,67200,689287397
2018-01-23,16471086,687460041,0,20000,66400,687526441
2018-01-24,24464605,676432412,0,20000,67200,676499612
2018-01-25,18943666,673660576,0,20000,67000,673727576
2018-01-26,9691913,669675400,0,20000,67200,669742600
2018-01-29,18777145,670213589,0,20000,66200,670279789
2018-01-30,7691141,668394742,0,20000,66000,668460742
2018-01-31,17933051,657214715,28000,33000,111870,657326585
2018-02-01,18251386,654801204,0,5000,16500,654817704
2018-02-02,20698583,651097681,0,5000,16100,651113781
2018-02-05,7856692,652228066,0,5000,16150,652244216
2018-02-06,13403376,647881286,15700,20700,62721,647944007
2018-02-07,11329454,645127087,0,5000,15350,645142437
2018-02-08,9273795,641856129,0,5000,15550,641871679
2018-02-09,10459015,637304196,15700,20700,63756,637367952
2018-02-12,7645842,629854213,15000,20000,63400,629917613
2018-02-13,4486617,623175507,1000,6000,18960,623194467
2018-02-14,6338628,615562319,0,5000,15650,615577969
2018-02-22,13493328,619964568,0,5000,15900,619980468
2018-02-23,4495137,614258348,0,5000,15850,614274198
2018-02-26,21628819,620117714,2500,7500,24450,620142164
2018-02-27,13364029,617470422,4900,12400,40300,617510722
2018-02-28,34451990,626428493,39000,46500,155775,626584268
2018-03-01,12913105,619950557,0,7500,25275,619975832
2018-03-02,14303769,615228350,0,7500,24750,615253100
2018-03-05,13387904,608352302,33000,40500,137295,608489597
2018-03-06,19893654,609129475,19200,44700,152427,609281902
2018-03-07,36902445,613754495,15600,36300,125961,613880456
2018-03-08,27379472,616779836,0,20700,71415,616851251
2018-03-09,25545418,618296097,5000,25700,88922,618385019
2018-03-12,29715996,622699906,0,12700,44323,622744229
2018-03-13,36534997,643580631,39600,52300,180958,643761589
2018-03-14,42922981,664554534,0,7700,25795,664580329
2018-03-15,11221084,660263687,39600,47300,159401,660423088
2018-03-16,36826110,656485775,0,47300,163185,656648960
2018-03-19,27948265,655401117,0,47300,160347,655561464
2018-03-20,15409572,656789170,0,7800,26130,656815300
2018-03-21,14147907,653101788,0,7800,25740,653127528
2018-03-22,15302700,659021934,5000,12800,41472,659063406
2018-03-23,15602740,649515917,8000,19800,60390,649576307
2018-03-26,17290135,650344403,0,11800,36698,650381101
2018-03-27,13524127,645036127,0,7800,24804,645060931
2018-03-28,6758139,643521360,13000,20800,65520,643586880
2018-03-29,6443311,640882459,0,7800,24804,640907263
2018-03-30,16078981,642466994,0,7800,25272,642492266
2018-04-02,20079179,647794415,13000,20800,68016,647862431
2018-04-03,10048176,646421025,0,5300,16854,646437879
2018-04-04,8043901,633565514,39500,44800,140672,633706186
2018-04-09,6788407,631122369,0,5300,16642,631139011
2018-04-10,7278647,631914237,0,5300,16801,631931038
2018-04-11,9916405,617804153,0,5300,16748,617820901
2018-04-12,7031375,614051678,0,5300,16589,614068267
2018-04-13,3068583,613087908,0,5100,16014,613103922
2018-04-16,7066949,614262706,0,5100,15912,614278618
2018-04-17,10247560,616780354,6600,11700,36738,616817092
2018-04-18,39549752,604046827,39100,50800,163576,604210403
2018-04-19,19522118,605277677,0,14300,45760,605323437
2018-04-20,59144143,608832249,46000,60300,198990,609031239
2018-04-23,47287381,620841080,0,20800,69264,620910344
2018-04-24,30295770,620947289,0,20800,69680,621016969
2018-04-25,21524876,625463649,0,20800,68640,625532289
2018-04-26,25255195,611413574,39500,60300,198990,611612564
2018-04-27,16893308,603356615,0,5700,18411,603375026
2018-05-02,14323529,605283655,0,5700,18411,605302066
2018-05-03,23683571,607504663,13300,19000,62700,607567363
2018-05-04,17467157,608952646,0,5600,18256,608970902
2018-05-07,14481842,612995154,0,5600,18312,613013466
2018-05-08,10155296,608814241,0,5600,18256,608832497
2018-05-09,18091769,602439351,39000,44600,146288,602585639
2018-05-10,15349422,604611173,10000,15500,50530,604661703
2018-05-11,10961388,601189688,0,15500,50375,601240063
2018-05-14,15507285,600967281,0,15500,49600,601016881
2018-05-15,14574668,591248161,19200,34700,110693,591358854
2018-05-16,18329902,597074526,5700,40400,126856,597201382
2018-05-17,8127121,594936076,0,24700,77311,595013387
2018-05-18,11917434,594876805,0,24700,77311,594954116
2018-05-21,12129426,593191360,0,24700,78299,593269659
2018-05-22,11251278,594937831,0,24700,78546,595016377
2018-05-23,9726558,589170199,0,24700,77064,589247263
2018-05-24,8093657,584240865,27700,52400,162964,584403829
2018-05-25,7860575,581053636,1000,53400,164472,581218108
2018-05-28,6313861,579410706,0,13800,42366,579453072
2018-05-29,4151116,576772741,0,13800,42228,576814969
2018-05-30,15469560,570385057,2500,16300,48900,570433957
2018-05-31,10794080,572806387,0,16300,49552,572855939
2018-06-01,9258427,572310565,4200,20500,61910,572372475
2018-06-04,4599472,570666603,0,5000,15250,570681853
2018-06-05,11183444,572530542,15700,20700,63963,572594505
2018-06-06,3335922,570689959,0,20700,63756,570753715
2018-06-07,6446620,565732142,0,20700,62721,565794863
2018-06-08,9416746,567087587,0,5000,15200,567102787
2018-06-11,3627810,562808715,44800,49800,150894,562959609
2018-06-12,5274341,564059591,100,10300,31312,564090903
2018-06-13,3560267,563848797,100,5200,15652,563864449
2018-06-14,6272536,562149099,0,5200,15496,562164595
2018-06-15,13529901,552051882,15500,20700,58374,552110256
2018-06-19,16459887,537113678,35000,55600,141224,537254902
2018-06-20,7444134,527120105,0,20600,52530,527172635
2018-06-21,10849452,522002803,0,20600,50058,522052861
2018-06-22,7119728,516924946,39600,60200,146286,517071232
2018-06-25,5664474,514074596,0,20600,49440,514124036
2018-06-26,9171149,513930658,0,5100,12393,513943051
2018-06-27,5028833,510591854,2700,7800,18954,510610808
2018-06-28,7913296,502253639,5000,12800,30848,502284487
2018-06-29,9460296,505742926,10600,16100,39928,505782854
2018-07-02,5932603,504396599,4600,20700,50301,504446900
2018-07-03,10869324,502340511,0,20300,50547,502391058
2018-07-04,3296618,500234023,400,20700,50508,500284531
2018-07-05,3453013,495491560,7500,28200,66552,495558112
2018-07-06,3261492,492415560,0,16600,40172,492455732
2018-07-09,5132720,492998397,11600,28200,69372,493067769
2018-07-10,5119064,494431991,0,16600,41002,494472993
2018-07-11,5992164,492119269,2300,18900,45360,492164629
2018-07-12,8269208,490017018,32000,50900,125723,490142741
2018-07-13,4500002,490869019,0,18900,46494,490915513
2018-07-16,6037560,488839781,5000,23900,57838,488897619
2018-07-17,2246603,488907130,0,23900,57838,488964968
2018-07-18,3712043,487683834,0,11400,27474,487711308
2018-07-19,4764417,482003138,39600,48700,113958,482117096
2018-07-20,5462929,482586997,11600,20700,49059,482636056
2018-07-23,5998567,481031080,0,20700,49887,481080967
2018-07-24,8374288,483636020,0,9100,22386,483658406
2018-07-25,7733397,486104895,0,9100,22477,486127372
2018-07-26,17015117,488637457,51200,60300,153765,488791222
2018-07-27,18673792,486905834,0,20700,54027,486959861
2018-07-30,13362004,488882020,0,20700,52371,488934391
2018-07-31,6027865,489992964,0,14100,35250,490028214
2018-08-01,9081720,489763967,0,14100,34827,489798794
2018-08-02,5248897,484019604,6600,20700,49266,484068870
2018-08-03,4275303,483335503,0,16700,39579,483375082
2018-08-06,6060661,483452753,4000,20700,48645,483501398
2018-08-07,4917569,484032709,0,16700,40247,484072956
2018-08-08,3529781,483051640,0,14100,33558,483085198
2018-08-09,15090458,489450321,41600,55700,138693,489589014
2018-08-10,6959265,484080130,0,20700,51336,484131466
2018-08-13,7757947,483578947,0,9100,22477,483601424
2018-08-14,6216936,482983960,0,9100,22295,483006255
2018-08-15,5744776,480618612,51600,60700,145073,480763685
2018-08-16,3628324,479482610,0,57700,136749,479619359
2018-08-17,2602102,472843171,41000,90100,210834,473054005
2018-08-20,3585586,471703168,5600,91700,217329,471920497
2018-08-21,3357515,471821578,10000,101700,242046,472063624
2018-08-22,3841571,472909377,36900,138600,327096,473236473
2018-08-23,3050810,472099193,27000,155600,367216,472466409
2018-08-24,3290708,470857473,0,155500,365425,471222898
2018-08-27,9100006,474232608,0,137500,328625,474561233
2018-08-28,2896187,473926259,0,137500,327250,474253509
2018-08-29,4157839,470548788,0,137500,323125,470871913
2018-08-30,4372460,472567010,20700,158200,368606,472935616
2018-08-31,9663328,468639450,0,132500,295475,468934925
2018-09-03,8422345,456840612,8800,141300,305208,457145820
2018-09-04,9586626,458172537,3200,144500,315010,458487547
2018-09-05,10990522,456340201,2000,146500,319370,456659571
2018-09-06,5003486,455581452,0,146500,316440,455897892
2018-09-07,2723483,452251861,0,146500,316440,452568301
2018-09-10,3272149,449232801,0,146500,306185,449538986
2018-09-11,3711075,449542482,0,132500,278250,449820732
2018-09-12,4162644,447681508,0,126500,265650,447947158
2018-09-13,7015345,449901001,0,126500,266915,450167916
2018-09-14,3766799,448538402,10000,136500,286650,448825052
2018-09-17,4543940,445571460,7000,143500,294175,445865635
2018-09-18,4619587,442636652,0,108500,225680,442862332
2018-09-19,4741943,442364154,0,103600,217560,442581714
2018-09-20,11660565,443601620,12700,116300,246556,443848176
2018-09-21,9678598,440230074,0,103000,220420,440450494
2018-09-25,3823758,440936950,0,103000,217330,441154280
2018-09-26,5186441,443732053,0,103000,218360,443950413
2018-09-27,2788978,442040644,200,103200,214656,442255300
2018-09-28,8024442,438383063,8400,111400,237282,438620345
2018-10-08,13141719,443958392,0,22000,45540,444003932
2018-10-09,4860329,442056137,15700,37700,78039,442134176
2018-10-10,4044086,442448269,0,5000,10350,442458619
2018-10-11,6316411,425454354,39600,44600,83402,425537756
2018-10-12,6971334,409432771,7800,12800,22912,409455683
2018-10-15,4739813,407295716,0,12800,22528,407318244
2018-10-16,4769439,400650934,0,5000,8650,400659584
2018-10-17,2996030,399090681,12300,17300,30621,399121302
2018-10-18,4600380,397040288,0,5000,8550,397048838
2018-10-19,5595738,397321806,25000,30000,51900,397373706
2018-10-22,4423432,392343685,15900,45900,83538,392427223
2018-10-23,3231788,390801623,11100,41100,74802,390876425
2018-10-24,5383068,391570263,21000,62100,113022,391683285
2018-10-25,4696894,390950290,0,62100,113022,391063312
2018-10-26,4056874,389925806,0,62100,114264,390040070
2018-10-29,3218632,389885926,0,62100,113643,389999569
2018-10-30,10877142,391955969,7500,69600,131544,392087513
2018-10-31,9123783,394615878,0,62100,117369,394733247
2018-11-01,10622639,393257466,7500,69600,132936,393390402
2018-11-02,7475696,393492823,0,62100,120474,393613297
2018-11-05,6575896,389949609,0,52800,104544,390054153
2018-11-06,3887931,389094685,0,52800,104016,389198701
2018-11-07,5615524,387852261,0,52800,102960,387955221
2018-11-08,8483351,384628928,7000,59800,118404,384747332
2018-11-09,6482663,383904896,0,52800,103488,384008384
2018-11-12,12847136,384056031,0,52800,107712,384163743
2018-11-13,30072212,392307917,7500,60300,131454,392439371
2018-11-14,13255534,392540757,0,60300,130248,392671005
2018-11-15,13208514,398874418,0,52800,115104,398989522
2018-11-16,9586947,393835521,0,20700,45540,393881061
2018-11-19,8513737,391842594,0,20700,44919,391887513
2018-11-20,7948504,392709308,0,20700,43056,392752364
2018-11-21,4435097,392932388,0,20700,43263,392975651
2018-11-22,15030569,394692389,17100,37800,82404,394774793
2018-11-23,11218423,390274181,4000,24700,50882,390325063
2018-11-26,6792921,391595658,35600,56300,117667,391713325
2018-11-27,4559321,389237386,0,20700,43056,389280442
2018-11-28,9717731,391307363,0,20700,43677,391351040
2018-11-29,10452030,389685913,0,20700,42021,389727934
2018-11-30,6234123,386993377,0,20700,41814,387035191
2018-12-03,7134671,385708740,29500,50200,105922,385814662
2018-12-04,5545971,387248959,0,20700,43677,387292636
2018-12-05,9398202,386103719,0,20700,43263,386146982
2018-12-06,9867787,387291897,27400,48100,98124,387390021
2018-12-07,3999020,385544269,0,20700,42435,385586704
2018-12-10,3317241,385308863,0,20700,41607,385350470
2018-12-11,2575660,384388698,39600,60300,123012,384511710
2018-12-12,1835997,383485836,0,20700,42228,383528064
2018-12-13,7982818,386565545,0,20700,42642,386608187
2018-12-14,4180210,383499412,0,20700,42021,383541433
2018-12-17,3408154,382889799,0,20700,41814,382931613
2018-12-18,3997778,383395292,0,20700,41400,383436692
2018-12-19,4143396,382304809,0,20700,40572,382345381
2018-12-20,4703900,383746446,0,20700,40779,383787225
2018-12-21,1969568,381632675,0,20700,40572,381673247
2018-12-24,3355185,382309200,150600,165600,326232,382635432
2018-12-25,4265947,378910909,0,165600,319608,379230517
2018-12-26,2312044,378210701,0,165600,319608,378530309
2018-12-27,3627197,379255887,39600,205200,389880,379645767
2018-12-28,3631060,375796043,0,165600,314640,376110683
2019-01-02,5011377,376708372,0,165600,314640,377023012
2019-01-03,2182630,376753045,0,165600,314640,377067685
2019-01-04,4461639,376026326,0,165600,321264,376347590
2019-01-07,6876119,377559329,0,165600,331200,377890529
2019-01-08,9894716,376771213,35000,200600,409224,377180437
2019-01-09,13198759,378404016,0,165600,337824,378741840
2019-01-10,8799063,378501645,0,165600,341136,378842781
2019-01-11,5660968,375197569,44700,210300,437424,375634993
2019-01-14,4119869,375084321,0,210300,435321,375519642
2019-01-15,6600879,374721653,0,171300,354591,375076244
2019-01-16,6227986,374482447,0,171300,351165,374833612
2019-01-17,17336329,382256988,10000,181300,377104,382634092
2019-01-18,12450539,382612848,0,171300,356304,382969152
2019-01-21,8510157,379184953,0,171300,354591,379539544
2019-01-22,11871438,381892746,0,171300,349452,382242198
2019-01-23,3416063,380909767,0,171300,347739,381257506
2019-01-24,22224153,379267692,0,171300,359730,379627422
2019-01-25,25447256,374443060,29600,200900,431935,374874995
2019-01-28,16388775,378738602,0,171300,352878,379091480
2019-01-29,7773610,374779375,21600,187200,372528,375151903
2019-01-30,3655979,372403654,0,165600,324576,372728230
2019-01-31,5186141,369872002,39600,205200,398088,370270090
2019-02-01,2573495,365032111,0,165600,331200,365363311
2019-02-11,8106102,363596853,0,165600,342792,363939645
2019-02-12,10627548,365727074,41500,207100,439052,366166126
2019-02-13,40950093,381901222,3200,171300,380286,382281508
2019-02-14,19948407,379848715,39000,210300,460557,380309272
2019-02-15,17337788,380903335,0,171300,373434,381276769
2019-02-18,78679973,412656710,39600,210900,506160,413162870
2019-02-19,60834462,410168170,0,210900,556776,410724946
2019-02-20,76549552,420350595,0,190100,499963,420850558
2019-02-21,58771894,430688669,0,190100,482854,431171523
2019-02-22,38968929,427113610,0,165600,422280,427535890
2019-02-25,87323629,433852570,45300,205900,578579,434431149
2019-02-26,77881236,406557360,0,156600,438480,406995840
2019-02-27,43935169,409853763,1600,158200,436632,410290395
2019-02-28,29775535,415171788,16700,174900,486222,415658010
2019-03-01,25806332,408894651,20100,185000,516150,409410801
2019-03-04,78418585,429362705,25900,190800,555228,429917933
2019-03-05,141495746,482185884,20100,210900,674880,482860764
2019-03-06,112374262,444538287,0,201600,665280,445203567
2019-03-07,91475404,451831102,9300,210900,691752,452522854
2019-03-08,134252209,479395873,0,209300,694876,480090749
2019-03-11,98597327,491608422,1600,172900,596505,492204927
2019-03-12,121041033,486311942,23000,45300,161721,486473663
2019-03-13,82740020,474176411,100,33800,112554,474288965
2019-03-14,48550218,462999737,20800,41500,127405,463127142
2019-03-15,32848637,460702695,0,20700,63963,460766658
2019-03-18,32744572,465360578,0,13000,40950,465401528
2019-03-19,27354195,457962853,0,13000,41080,458003933
2019-03-20,42169941,465038731,0,13000,40820,465079551
2019-03-21,78570395,468356078,54800,67800,225774,468581852
2019-03-22,62086941,470432326,0,12700,42037,470474363
2019-03-25,153717559,511139863,56100,68800,250432,511390295
2019-03-26,96213487,483156984,0,67800,224418,483381402
2019-03-27,40768785,481394439,0,56600,183384,481577823
2019-03-28,34246158,483574807,0,56600,178856,483753663
2019-03-29,40036005,485228917,3100,11300,36951,485265868
2019-04-01,47357807,477226852,52000,63300,213321,477440173
2019-04-02,54341876,479720358,1000,21600,73440,479793798
2019-04-03,39784228,483902513,7700,29300,99327,484001840
2019-04-04,42189907,482997329,0,29300,98155,483095484
2019-04-08,41224573,479634429,31800,49900,161676,479796105
2019-04-09,27929542,483624723,7900,57800,189006,483813729
2019-04-10,23894068,480450907,2100,59100,189711,480640618
2019-04-11,20000349,479487510,3600,62700,195624,479683134
2019-04-12,17952109,478250896,3000,65700,205641,478456537
2019-04-15,15053367,471609407,3100,68800,213280,471822687
2019-04-16,26026383,476962811,0,68800,218784,477181595
2019-04-17,32140558,475144909,0,37000,118400,475263309
2019-04-18,111322329,467507169,31800,65900,223401,467730570
2019-04-19,76554753,485142821,2900,37800,122094,485264915
2019-04-22,32066950,484573422,0,37000,117290,484690712
2019-04-23,22026156,482814840,0,37000,115810,482930650
2019-04-24,22575995,472237961,31800,68800,222224,472460185
2019-04-25,28250033,476911280,0,37000,114700,477025980
2019-04-26,9399585,473861782,6400,43400,132804,473994586
2019-04-29,22749303,467398525,4400,44900,131108,467529633
2019-04-30,7815126,464440660,8100,48600,146286,464586946
2019-05-06,18330327,451834197,0,40700,112332,451946529
2019-05-07,9412519,446022041,15200,52900,148120,446170161
2019-05-08,9539229,444353518,19200,59800,165646,444519164
2019-05-09,7426802,441561899,400,31700,88443,441650342
2019-05-10,20519751,439815887,12500,44200,129948,439945835
2019-05-13,23439297,432616222,31800,76000,230280,432846502
2019-05-14,16359708,433530553,0,41100,121656,433652209
2019-05-15,15225687,438307859,2700,43700,131100,438438959
2019-05-16,14442576,440599416,500,44200,131716,440731132
2019-05-17,13811253,436731961,100,41600,118560,436850521
2019-05-20,13801625,439783875,2700,44300,130685,439914560
2019-05-21,12817107,433544486,0,43800,128772,433673258
2019-05-22,18646145,438630448,31700,75500,227255,438857703
2019-05-23,13496684,436432535,0,31300,90457,436522992
2019-05-24,5682617,432455284,13000,44300,126255,432581539
2019-05-27,15052449,434066484,0,44300,131571,434198055
2019-05-28,8421160,432246610,14600,58900,173166,432419776
2019-05-29,16007947,436967421,17000,75900,225423,437192844
2019-05-30,8796223,434301132,0,58900,170221,434471353
2019-05-31,4876358,429029367,4200,63100,182359,429211726
2019-06-03,6879304,425423383,12900,61400,174376,425597759
2019-06-04,6111422,424232455,14000,62500,174375,424406830
2019-06-05,4640808,425482173,13500,62000,172980,425655153
2019-06-06,4627728,425561193,14000,71800,195296,425756489
2019-06-10,2600293,425470898,0,58300,159742,425630640
2019-06-11,15035055,429186237,17600,52000,148200,429334437
2019-06-12,5919693,430270525,0,35000,98350,430368875
2019-06-13,2251624,428727168,31100,66100,187063,428914231
2019-06-14,4398763,425014375,0,66100,183097,425197472
2019-06-17,2194411,424778101,0,66100,183758,424961859
2019-06-18,2850253,426231316,0,66100,183097,426414413
2019-06-19,8884441,426898910,0,66100,184419,427083329
2019-06-20,9740983,421480225,0,65400,183774,421663999
2019-06-21,10284528,422232768,0,51100,144613,422377381
2019-06-24,7311062,420832154,0,51100,143591,420975745
2019-06-25,8508510,424444854,0,20000,55400,424500254
2019-06-26,3385916,424794762,0,20000,55400,424850162
2019-06-27,2728111,423384527,0,20000,55600,423440127
2019-06-28,3334432,420583839,11100,31100,85214,420669053
2019-07-01,14132306,424595119,28000,59100,167253,424762372
2019-07-02,28807230,426531437,4600,35700,104244,426635681
2019-07-03,22605714,431564852,31800,62900,186813,431751665
2019-07-04,16326043,427920167,0,31100,90812,428010979
2019-07-05,7733943,426838205,0,31100,91123,426929328
2019-07-08,8927514,423084001,4600,35700,101745,423185746
2019-07-09,4490910,420977737,3500,23500,67210,421044947
2019-07-10,5723728,421886524,100,23600,67732,421954256
2019-07-11,5746177,421509080,15000,38600,109624,421618704
2019-07-12,5545961,420360718,30000,68600,195510,420556228
2019-07-15,11608620,418213155,0,23600,68676,418281831
2019-07-16,8926122,417404686,45700,69300,203049,417607735
2019-07-17,15141875,420370613,1800,25400,75438,420446051
2019-07-18,5332121,416844710,15000,38600,113098,416957808
2019-07-19,6317661,416624324,0,38600,113484,416737808
2019-07-22,4147224,409033380,0,38600,110396,409143776
2019-07-23,4868457,408904047,0,23600,68204,408972251
2019-07-24,14381473,413336165,0,23600,69620,413405785
2019-07-25,14346159,414337065,31800,55400,163430,414500495
2019-07-26,3829533,406046109,0,23600,69148,406115257
2019-07-29,6551773,404422418,0,23600,68912,404491330
2019-07-30,4685658,403993134,0,23600,68912,404062046
2019-07-31,5398442,400945215,0,23600,67732,401012947
2019-08-01,5746246,399330249,30000,53500,150870,399481119
2019-08-02,6785771,392396111,0,23500,64860,392460971
2019-08-05,4507986,390770891,0,23500,65095,390835986
2019-08-06,5575337,389921103,15600,39100,105570,390026673
2019-08-07,1985224,387424583,0,32800,87248,387511831
2019-08-08,4209778,388240342,38100,70900,189303,388429645
2019-08-09,3091676,385831159,0,70900,188594,386019753
2019-08-12,4961632,386353117,0,70900,191430,386544547
2019-08-13,3001808,386855726,0,70900,187176,387042902
2019-08-14,6211249,384315520,0,63100,169108,384484628
2019-08-15,6659678,385266666,0,13700,36442,385303108
2019-08-16,7805651,385367813,0,13700,36579,385404392
2019-08-19,15729084,386644225,16900,30600,85986,386730211
2019-08-20,24738867,392680557,36900,50700,146016,392826573
2019-08-21,10371634,389086629,0,23500,67210,389153839
2019-08-22,23756104,396453970,28000,51500,152440,396606410
2019-08-23,13542733,393418515,0,23500,67680,393486195
2019-08-26,21147515,385536663,35100,58600,176972,385713635
2019-08-27,25541542,393862907,0,39100,117300,393980207
2019-08-28,9728971,387038640,0,39100,114563,387153203
2019-08-29,11612494,385512204,0,39100,115345,385627549
2019-08-30,7525721,383697730,25000,64100,183967,383881697
2019-09-02,4480836,374966476,3400,26800,79596,375046072
2019-09-03,16109971,376715666,3500,30300,91809,376807475
2019-09-04,13074475,380819152,0,30300,91203,380910355
2019-09-05,25540004,388248983,0,20300,61915,388310898
2019-09-06,15569946,394372739,30000,50300,151906,394524645
2019-09-09,23952931,396161683,0,20300,62524,396224207
2019-09-10,21456598,398412697,15000,35300,108371,398521068
2019-09-11,9516882,393974793,16000,36300,109989,394084782
2019-09-12,12133643,388900645,15500,35800,107758,389008403
2019-09-16,7314095,387091393,0,20300,61103,387152496
2019-09-17,8614819,382692440,0,20300,59276,382751716
2019-09-18,4630055,375515510,0,20300,59276,375574786
2019-09-19,12179316,378742314,0,20300,60088,378802402
2019-09-20,4146042,374572198,0,20300,60494,374632692
2019-09-23,4852467,370818539,0,20300,59479,370878018
2019-09-24,4568883,363184774,0,20300,59276,363244050
2019-09-25,8058340,366017371,0,7200,20376,366037747
2019-09-26,4307138,364288330,0,7200,19800,364308130
2019-09-27,2803092,362393636,20000,27200,76160,362469796
2019-09-30,1311588,358501600,0,6800,18972,358520572
2019-10-08,4903603,360868208,0,6800,19108,360887316
2019-10-09,2721007,361960715,0,6800,19244,361979959
2019-10-10,4847158,359860248,0,6800,19516,359879764
2019-10-11,4442388,357006609,0,6800,19584,357026193
2019-10-14,11233859,360672568,0,6800,19652,360692220
2019-10-15,20745254,363614369,0,6800,20128,363634497
2019-10-16,11341734,366216525,0,6800,19720,366236245
2019-10-17,6911711,367694167,0,6800,19788,367713955
2019-10-18,2447645,363700981,0,6600,18876,363719857
2019-10-21,2916859,362043997,0,6600,18744,362062741
2019-10-22,2077152,359275817,0,6400,18304,359294121
2019-10-23,3379923,358094655,0,5900,16756,358111411
2019-10-24,2491478,355718560,0,5900,16756,355735316
2019-10-25,4284192,355280218,0,5700,16416,355296634
2019-10-28,8681208,358651603,0,5700,16815,358668418
2019-10-29,5581079,358357570,0,5700,16644,358374214
2019-10-30,4304893,358707480,100,5800,16936,358724416
2019-10-31,17933201,362496117,26700,32500,95875,362591992
2019-11-01,12702204,355069618,0,12100,35937,355105555
2019-11-04,7926784,357547174,0,5300,15635,357562809
2019-11-05,26375019,363537013,402900,408200,1245010,364782023
2019-11-06,14671302,366652283,0,370200,1129110,367781393
2019-11-07,8115146,364090431,0,370200,1132812,365223243
2019-11-08,9001159,357605220,15100,357400,1082922,358688142
2019-11-11,8500821,352777965,0,357400,1043608,353821573
2019-11-12,4801628,351548100,0,357400,1036460,352584560
2019-11-13,5418890,353226691,110000,467400,1336764,354563455
2019-11-14,5761997,353348043,0,467400,1364808,354712851
2019-11-15,10405693,357437884,0,115300,323993,357761877
2019-11-18,5737954,355324604,3700,119000,337960,355662564
2019-11-19,5530624,355953515,40900,159900,458913,356412428
2019-11-20,3794864,354265798,0,159900,455715,354721513
2019-11-21,3011838,353277051,0,118500,336540,353613591
2019-11-22,6163608,353272002,0,118000,333940,353605942
2019-11-25,5185507,354701614,0,118000,332760,355034374
2019-11-26,4322483,352360892,0,118000,336300,352697192
2019-11-27,7200000,354237481,177000,295000,849600,355087081
2019-11-28,8100994,357356892,0,295000,858450,358215342
2019-11-29,7627939,355772435,0,295000,861400,356633835
2019-12-02,4321026,358298908,0,294700,854630,359153538
2019-12-03,2851704,357335094,0,294700,851683,358186777
2019-12-04,13375241,361870044,0,294700,875259,362745303
2019-12-05,13692521,361701428,0,294700,884100,362585528
2019-12-06,6414350,360972554,0,7700,23254,360995808
2019-12-09,5934241,361093412,0,7700,23177,361116589
2019-12-10,29186773,375615098,0,7700,23639,375638737
2019-12-11,22710346,375593667,0,7700,23870,375617537
2019-12-12,41577767,381622802,0,7700,25102,381647904
2019-12-13,35895124,378959924,0,7500,24375,378984299
2019-12-16,79284207,388514845,0,7500,26325,388541170
2019-12-17,134247166,434626201,418300,425800,1579718,436205919
2019-12-18,99880834,445961152,0,425800,1579718,447540870
2019-12-19,52087374,436890214,0,425800,1549912,438440126
2019-12-20,51412273,429806826,0,7500,26100,429832926
2019-12-23,40841234,441537575,0,7200,24768,441562343
2019-12-24,35632536,445256009,20000,27200,95472,445351481
2019-12-25,36240984,441869617,0,7200,24984,441894601
2019-12-26,49430779,449853255,84300,91500,321165,450174420
2019-12-27,38137175,437890150,0,91500,312015,438202165
2019-12-30,20716496,430033611,0,91500,314760,430348371
2019-12-31,17564911,429154645,0,91500,318420,429473065
2020-01-02,28593583,432884177,0,91500,322080,433206257
2020-01-03,59917019,436544088,284000,375500,1363065,437907153
2020-01-06,58016959,434954602,120000,495500,1858125,436812727
2020-01-07,43252367,442010919,0,495500,1833350,443844269
2020-01-08,58762186,420216492,0,7200,26280,420242772
2020-01-09,31609010,420275312,68300,75500,275575,420550887
2020-01-10,31900332,424986517,0,7200,25920,425012437
2020-01-13,21719702,424361183,20000,27200,100096,424461279
2020-01-14,20542394,420847300,0,7200,26064,420873364
2020-01-15,17243288,416308197,0,7200,26064,416334261
2020-01-16,90057899,441568114,40000,47200,182664,441750778
2020-01-17,67063663,428534699,0,27200,106352,428641051
2020-01-20,56287845,427285036,0,7200,28800,427313836
2020-01-21,43768918,416388426,0,7200,28080,416416506
2020-01-22,60293777,441098310,0,7200,28944,441127254
2020-01-23,89512174,445642889,0,7200,28008,445670897
2020-02-03,48438118,432583129,0,7200,25200,432608329
2020-02-04,53298802,417868309,0,7200,27720,417896029
2020-02-05,129580447,454692853,0,7200,30528,454723381
2020-02-06,130286840,493578521,0,7200,31104,493609625
2020-02-07,108804426,462039842,0,7200,30816,462070658
2020-02-10,103089684,496605565,0,7200,31104,496636669
2020-02-11,56313251,485816031,0,7200,30168,485846199
2020-02-12,126942928,527445835,0,7200,31752,527477587
2020-02-13,94110603,551810110,0,7200,31176,551841286
2020-02-14,115709593,567298136,0,3500,15400,567313536
2020-02-17,155028711,584010516,3100,6600,30030,584040546
2020-02-18,111530850,564947522,600,4100,18573,564966095
2020-02-19,88438466,545111098,0,3500,15435,545126533
2020-02-20,128718449,525243743,3700,7200,34920,525278663
2020-02-21,276579154,600306275,0,7200,38448,600344723
2020-02-24,262774182,651973514,40900,48100,282347,652255861
2020-02-25,436628090,848926943,0,27700,178942,849105885
2020-02-26,374556153,840524789,20400,27700,174510,840699299
2020-02-27,287392481,865080428,39500,47700,284292,865364720
2020-02-28,208753222,809884995,20400,24000,128640,810013635
2020-03-02,223376338,832730133,44000,47600,264656,832994789
2020-03-03,185139977,800891070,20400,47600,271320,801162390
2020-03-04,182660741,812363832,20400,27600,149316,812513148
2020-03-05,132629639,767624610,40400,47600,270368,767894978
2020-03-06,89371086,763414549,0,27100,148508,763563057
2020-03-09,91855495,753875153,0,7100,36565,753911718
2020-03-10,129328309,746212791,0,7100,38411,746251202
2020-03-11,129530521,725683178,40900,48000,238560,725921738
2020-03-12,74343670,709753574,20000,47600,223720,709977294
2020-03-13,100907775,700262528,20400,27600,131100,700393628
2020-03-16,66375145,682546990,20400,27600,119508,682666498
2020-03-17,109154540,691881797,40400,47600,218960,692100757
2020-03-18,80035847,673296181,0,27100,125744,673421925
2020-03-19,115087955,708819735,0,27100,131977,708951712
2020-03-20,74825676,701519521,0,7100,34009,701553530
2020-03-23,72456556,707499123,41000,48100,211640,707710763
2020-03-24,86007523,713210008,0,48000,216000,713426008
2020-03-25,86241459,707637168,0,48000,219360,707856528
2020-03-26,41181342,697058718,0,27600,122268,697180986
2020-03-27,43792284,711380063,0,27600,121164,711501227
2020-03-30,47265737,690755611,100,7200,30024,690785635
2020-03-31,28783715,686106470,0,7200,29592,686136062
2020-04-01,58250368,691705066,40900,48100,202982,691908048
2020-04-02,36419341,678649507,17200,61700,273948,678923455
2020-04-03,27483901,675438304,0,44500,192240,675630544
2020-04-07,52213595,685323058,35100,79600,358996,685682054
2020-04-08,65278403,680707805,18000,86500,408280,681116085
2020-04-09,45510866,692809217,1700,80200,376138,693185355
2020-04-10,42013553,688275888,7300,11100,50394,688326282
2020-04-13,23348440,674639902,0,4200,18354,674658256
2020-04-14,25448069,682458776,7700,11400,51186,682509962
2020-04-15,37773235,684180226,31200,34900,153560,684333786
2020-04-16,24752387,668945035,12200,15900,69642,669014677
2020-04-17,49137198,683250304,66000,72500,320450,683570754
2020-04-20,63940877,684890039,700,7700,34958,684924997
2020-04-21,31064862,673178553,9600,16600,73538,673252091
2020-04-22,29336508,675625055,10200,17200,76540,675701595
2020-04-23,22322772,667047397,10200,17200,74648,667122045
2020-04-24,24740145,661873493,10200,17200,71896,661945389
2020-04-27,15759090,655389522,9000,12700,53086,655442608
2020-04-28,30687367,659380999,10200,13900,58936,659439935
2020-04-29,12612505,651218133,17300,21000,88200,651306333
2020-04-30,62620770,654492470,25500,44000,196680,654689150
2020-05-06,70864755,680451063,300,36600,168726,680619789
2020-05-07,40590454,680535370,0,3800,17100,680552470
2020-05-08,37097447,674303918,0,3800,17366,674321284
2020-05-11,40359088,665473600,0,3800,17328,665490928
2020-05-12,26870939,661943832,1100,4900,22589,661966421
2020-05-13,117520871,690434024,39400,44300,224601,690658625
2020-05-14,111042290,677420667,1900,6800,34204,677454871
2020-05-15,102755111,701316662,5200,12000,61200,701377862
2020-05-18,96613332,697849055,52000,64000,312960,698162015
2020-05-19,101679833,713780396,57500,92600,475964,714256360
2020-05-20,105194627,716237219,27000,74500,388890,716626109
2020-05-21,131497552,745436244,0,72500,371925,745808169
2020-05-22,94475457,745245876,26900,74400,383160,745629036
2020-05-25,88804143,749046896,47300,96700,467061,749513957
2020-05-26,48351065,754087603,0,71700,355632,754443235
2020-05-27,50365798,748232333,0,16900,81627,748313960
2020-05-28,50855265,738364311,97800,104600,490574,738854885
2020-05-29,63566656,758012783,29000,123200,587664,758600447
2020-06-01,79931443,725806508,0,93800,474628,726281136
2020-06-02,196913234,822881361,33000,126800,661896,823543257
2020-06-03,111708814,752293542,0,126800,658092,752951634
2020-06-04,59715214,733277783,0,126800,650484,733928267
2020-06-05,110089061,783815760,0,126800,661896,784477656
2020-06-08,136622766,789647736,6400,95800,506782,790154518
2020-06-09,65100492,766923636,0,89400,460410,767384046
2020-06-10,40352990,762398432,4900,61300,313856,762712288
2020-06-11,60413904,752540144,4300,15600,77844,752617988
2020-06-12,31248368,738047440,10000,21600,107568,738155008
2020-06-15,34385638,723106588,0,11600,56724,723163312
2020-06-16,36371960,722363423,0,11600,57768,722421191
2020-06-17,27397949,711909434,102300,113900,560388,712469822
2020-06-18,62539730,738186328,347600,461500,2307500,740493828
2020-06-19,40721378,721889041,313300,774800,3874000,725763041
2020-06-22,77029677,734032432,70200,839800,4333368,738365800
2020-06-23,37948567,719210368,337300,1173300,5972097,725182465
2020-06-24,33622915,717989110,271538,1421638,7122406,725111516
2020-06-29,38330415,707945249,86200,1371738,6680364,714625613
2020-06-30,26302427,711288340,118100,1465638,7254908,718543248
2020-07-01,36590351,694158391,615600,2079538,10106555,704264946
2020-07-02,73526426,723679305,301700,2347738,11738690,735417995
2020-07-03,55208364,710014221,107000,2052038,10362792,720377013
2020-07-06,147611926,715480737,159000,2005738,11051616,726532353
2020-07-07,115246273,679563081,321700,1982438,11121477,690684558
2020-07-08,134668395,702951674,265100,2061938,12701538,715653212
2020-07-09,200678319,746283929,464450,2381588,15337427,761621356
2020-07-10,118592567,733661343,202950,2397738,15297568,748958911
2020-07-13,208592554,799343467,271100,2242738,15654311,814997778
2020-07-14,194481928,813221011,276800,2065588,13302387,826523398
2020-07-15,202426391,857742480,465500,2222038,14198824,871941304
2020-07-16,129013797,840124459,59200,1877638,11190722,851315181
2020-07-17,180701962,855266342,274100,1951938,12648558,867914900
2020-07-20,172726549,905369680,133650,1792888,11940634,917310314
2020-07-21,350278517,1029099322,385400,1857888,13618320,1042717642
2020-07-22,294609053,991683461,260300,1885688,13784380,1005467841
2020-07-23,222744770,1020754098,584161,2218349,16016479,1036770577
2020-07-24,173725334,927319763,382800,2410999,15671494,942991257
2020-07-27,78525494,924311722,141200,2272049,14563834,938875556
2020-07-28,66245389,921533906,133700,1722049,11176098,932710004
2020-07-29,125353827,934669473,168400,1795649,12425891,947095364
2020-07-30,120551949,936278949,117600,1701449,11859099,948138048
2020-07-31,204838168,983264729,117100,1345149,9886845,993151574
2020-08-03,148638265,1001120973,117000,1390849,10320100,1011441073
2020-08-04,164858761,1000330280,75900,1430049,9881639,1010211919
2020-08-05,104068433,969843603,48700,1425149,9890534,979734137
2020-08-06,112507661,959504630,119500,1537749,10902640,970407270
2020-08-07,84579084,925804586,20100,1476049,10022373,935826959
2020-08-10,133202369,978783911,49300,1444649,9679149,988463060
2020-08-11,95281294,978334660,131400,1457461,9896160,988230820
2020-08-12,81734812,975370252,22900,1409761,9670960,985041212
2020-08-13,144214145,982914344,74900,1287961,9118764,992033108
2020-08-14,91805219,974487390,17300,880061,6107623,980595013
2020-08-17,139016627,985719786,54600,914261,6564394,992284180
2020-08-18,114861268,1033665424,52300,904561,6458566,1040123990
2020-08-19,78720320,1013901132,59800,960361,6549662,1020450794
2020-08-20,33902713,1007155551,30200,984861,6647812,1013803363
2020-08-21,42370293,989319889,3700,941261,6400575,995720464
2020-08-24,68062656,990517999,23100,842061,5835483,996353482
2020-08-25,240384735,1014809603,72300,867661,6611577,1021421180
2020-08-26,355994619,1104558609,7800,742761,5578135,1110136744
2020-08-27,156632484,1123008665,59400,626361,4572435,1127581100
2020-08-28,116377863,1086606727,58300,594961,4390812,1090997539
2020-08-31,198737568,1105674587,80100,639461,4738406,1110412993
2020-09-01,84598089,1075831166,288100,881261,6644708,1082475874
2020-09-02,112276773,1105547217,222100,1092161,8103835,1113651052
2020-09-03,95376299,1095596098,167200,1223561,8723990,1104320088
2020-09-04,64799917,1089720584,105700,1240261,8917477,1098638061
2020-09-07,96246320,1097983884,26800,1217261,8679071,1106662955
2020-09-08,63558295,1058640178,281000,1288061,8861860,1067502038
2020-09-09,67983954,1047492769,44200,1203061,7855988,1055348757
2020-09-10,43600582,1034316061,100,1170561,7386240,1041702301
2020-09-11,31320851,1023717265,129800,1195261,7745291,1031462556
2020-09-14,39520427,1023534424,55600,1248761,8279533,1031813957
2020-09-15,30621115,1002574050,42600,1219361,7999008,1010573058
2020-09-16,20707274,1002696422,15300,1152761,7446836,1010143258
2020-09-17,33020635,991671732,57500,1097861,7212947,998884679
2020-09-18,40828566,993334220,52200,1106761,7348893,1000683113
2020-09-21,28501034,989842459,48100,1154461,7584809,997427268
2020-09-22,21134548,979291426,38000,1094561,6961408,986252834
2020-09-23,18379157,983834859,0,1084161,6927789,990762648
2020-09-24,56869643,976580482,18500,1046461,6435735,983016217
2020-09-25,15058026,967375125,33500,951461,5841971,973217096
2020-09-28,25591739,962736390,41800,935361,5752470,968488860
2020-09-29,22608087,963293698,98600,1020061,6354980,969648678
2020-09-30,19093805,949435589,104900,996361,6157511,955593100
2020-10-09,47289607,956714951,13800,923261,5936568,962651519
2020-10-12,92766728,1002316255,1600,901961,6052158,1008368413
2020-10-13,40798185,993450342,135600,1028661,7056614,1000506956
2020-10-14,30832369,984373813,56700,1056761,7238813,991612626
2020-10-15,26638308,971484983,143082,1199843,8158933,979643916
2020-10-16,21591758,961661651,19300,1115343,7483951,969145602
2020-10-19,63214197,993944599,203200,1312143,8830723,1002775322
2020-10-20,42131231,991891655,26500,1218143,7966655,999858310
2020-10-21,31235751,986988362,53200,1069061,6831300,993819662
2020-10-22,14443418,977091387,144400,1180961,7569960,984661347
2020-10-23,30437223,982167752,45500,1107661,7066877,989234629
2020-10-26,25217675,986460944,121100,1189761,7507392,993968336
2020-10-27,17580320,985733049,83200,1185861,7494642,993227691
2020-10-28,19598031,987169689,115200,1297561,8252488,995422177
2020-10-29,31368848,974307572,83500,1274061,8001103,982308675
2020-10-30,36293578,959303306,91800,1155161,6965621,966268927
2020-11-02,23209160,959281774,33600,1090861,6708795,965990569
2020-11-03,30074440,949861654,14900,1095661,6891708,956753362
2020-11-04,27211712,957333271,67700,1037337,6452236,963785507
2020-11-05,49706969,968906861,54600,1055337,6754156,975661017
2020-11-06,25594264,966018757,29000,1048647,6637935,972656692
2020-11-09,68156848,957596918,6400,950647,6283776,963880694
2020-11-10,55391376,983226018,70700,920047,5915902,989141920
2020-11-11,40201551,960517867,61100,973047,6003700,966521567
2020-11-12,19672445,960993918,189600,1138447,6990065,967983983
2020-11-13,15976090,948651015,7700,1053347,6562352,955213367
2020-11-16,22458415,954720559,20800,1040647,6431198,961151757
2020-11-17,23659018,946403546,22500,1035447,6357645,952761191
2020-11-18,23234924,946886199,8300,1007147,6153668,953039867
2020-11-19,26860429,953222423,37300,974547,6012955,959235378
2020-11-20,19140611,938206350,23300,947847,5829259,944035609
2020-11-23,26351158,933410020,49900,945747,5778514,939188534
2020-11-24,29039041,944068111,500,821047,5016597,949084708
2020-11-25,36154386,914986719,88300,906147,5355329,920342048
2020-11-26,21992872,903801479,10600,890547,5120646,908922125
2020-11-27,19457415,891136978,30100,870347,4943570,896080548
2020-11-30,16946868,880580988,46800,850147,4803331,885384319
2020-12-01,93138702,885929480,70900,805547,5010502,890939982
2020-12-02,121000490,890872605,47300,688347,4446722,895319327
2020-12-03,75213694,900531747,42900,495786,3128410,903660157
2020-12-04,34716333,869867141,43400,461000,2895080,872762221
2020-12-07,70266422,886901389,102100,355900,2256406,889157795
2020-12-08,64105496,894408815,33400,382200,2453724,896862539
2020-12-09,48181797,879712159,0,363900,2270736,881982895
2020-12-10,30600793,872426927,0,328600,2014318,874441245
2020-12-11,37509872,866277014,600,293900,1760461,868037475
2020-12-14,27427622,866932975,13500,307400,1850548,868783523
2020-12-15,15436069,864926460,5400,271200,1619064,866545524
2020-12-16,16438848,855638441,0,150200,877168,856515609
2020-12-17,46248494,847741371,92900,243100,1548547,849289918
2020-12-18,45832810,860588559,147300,373000,2279030,862867589
2020-12-21,51090372,886281235,0,299700,1843155,888124390
2020-12-22,31686838,876660092,127900,404200,2380738,879040830
2020-12-23,30040045,881133479,24300,428500,2558145,883691624
2020-12-24,20785183,880780182,9600,438100,2545361,883325543
2020-12-25,24430807,872227059,20200,453800,2604812,874831871
2020-12-28,25854666,879390906,107800,560100,3164565,882555471
2020-12-29,23504457,875050188,101200,661300,3795862,878846050
2020-12-30,25214965,879680929,12100,666200,3830650,883511579
2020-12-31,112327873,886662749,198100,859800,5330760,891993509
2021-01-04,51665952,888151301,46100,809100,5048784,893200085
2021-01-05,69815859,894832387,89800,825300,5224149,900056536
2021-01-06,66001825,887222895,6100,714400,4393560,891616455
2021-01-07,35505590,871307682,113100,825700,4904658,876212340
2021-01-08,149032979,893037716,73100,696800,4550104,897587820
2021-01-11,202078178,937726463,85200,772400,5221424,942947887
2021-01-12,199132704,993251828,107800,705300,4915941,998167769
2021-01-13,145554364,1020361657,158000,842900,5799152,1026160809
2021-01-14,146121852,1039159581,1200,809900,5669300,1044828881
2021-01-15,114659500,1032288269,35600,748600,5060536,1037348805
2021-01-18,156306960,1044427523,32200,741500,5234990,1049662513
2021-01-19,102707032,1023064213,84500,824000,5652640,1028716853
2021-01-20,57438795,1013079665,13000,810300,5510040,1018589705
2021-01-21,96556710,1035258236,95900,814600,5514842,1040773078
2021-01-22,80141331,972977799,22800,738800,4890856,977868655
2021-01-25,149889508,975780898,64100,787100,5486087,981266985
2021-01-26,189530104,1029338462,416600,1137800,7862198,1037200660
2021-01-27,110169815,1030877332,162700,1292400,9008028,1039885360
2021-01-28,96208510,1030327883,157800,1449800,10061612,1040389495
2021-01-29,126782903,1070822197,125800,1441400,9614138,1080436335
2021-02-01,108339378,1019819125,125700,1443900,8807790,1028626915
2021-02-02,74263211,1042635993,192400,1540000,9486400,1052122393
2021-02-03,30526755,1021542388,164900,1644400,9817068,1031359456
2021-02-04,74811710,1022330268,132500,1753800,10610490,1032940758
2021-02-05,29751200,1012102930,184300,1777700,10399545,1022502475
2021-02-08,25270054,1003900077,28800,1793200,10561948,1014462025
2021-02-09,40764939,1008320158,114500,1884400,11419464,1019739622
2021-02-10,38285332,1009584380,44500,1908400,11507652,1021092032
2021-02-18,51256479,1018313614,44600,1914500,11850755,1030164369
2021-02-19,44643244,1018719592,44500,1920100,11981424,1030701016
2021-02-22,63407672,1027988607,108800,2009700,12319461,1040308068
2021-02-23,25250794,1010657467,47900,2057600,12613088,1023270555
2021-02-24,59148741,967433376,74700,2095700,12972383,980405759
2021-02-25,31152604,969927302,32300,2128000,12980800,982908102
2021-02-26,21766358,958763473,45346,2173346,13018343,971781816
2021-03-01,35808667,971889013,75400,2153546,13028953,984917966
2021-03-02,35872228,967155442,99000,2233246,13198484,980353926
2021-03-03,28520576,927581412,49500,2172646,13187961,940769373
2021-03-04,24362827,904230398,0,2104346,12541902,916772300
2021-03-05,33940318,892471148,43100,2080246,12668698,905139846
2021-03-08,38887876,888546664,227100,2188646,13263195,901809859
2021-03-09,48631277,891651037,223800,2400146,14424877,906075914
2021-03-10,24855738,890191016,32200,2370746,14082231,904273247
2021-03-11,35493192,885798400,276600,2628646,16008454,901806854
2021-03-12,21569759,881676025,89800,2718446,16446598,898122623
2021-03-15,31461992,887908833,15500,2733646,16183184,904092017
2021-03-16,29640635,883672992,25700,2665846,15808467,899481459
2021-03-17,18703652,881497038,48100,2661446,15782375,897279413
2021-03-18,31036319,878056005,126100,2750035,15950203,894006208
2021-03-19,16290160,852335218,169500,2831435,15969293,868304511
2021-03-22,21583988,855315040,98200,2822735,16004908,871319948
2021-03-23,17798640,856532254,146700,2860935,16135673,872667927
2021-03-24,25651652,844406670,150600,2892846,15389941,859796611
2021-03-25,5908087,837634912,44200,2888946,15455861,853090773
2021-03-26,5394018,834860350,231800,2883046,15626109,850486459
2021-03-29,12009145,831677390,95300,2966246,15869416,847546806
2021-03-30,13995163,823154335,98700,2960946,15752233,838906568
2021-03-31,9806939,825665147,238400,3045446,16201773,841866920
2021-04-01,9709130,827264687,85900,3112646,16683783,843948470
2021-04-02,34709678,828918676,190900,3159746,17599785,846518461
2021-04-06,24218214,829545520,198900,3335946,18347703,847893223
2021-04-07,10327494,823130023,22200,3357547,18500084,841630107
2021-04-08,9793350,820112525,78500,3336115,18248549,838361074
2021-04-09,11000093,810838819,175900,3399915,18393540,829232359
2021-04-12,10737873,807304544,105000,3394315,17854097,825158641
2021-04-13,7782238,807616130,99800,3345415,17697245,825313375
2021-04-14,20380528,807826087,97100,3211115,17564799,825390886
2021-04-15,42221041,821111984,272900,3309915,18469326,839581310
2021-04-16,18368430,814451102,167700,3261715,18232987,832684089
2021-04-19,44601816,835805076,49200,3179415,18281637,854086713
2021-04-20,21176841,827101313,214817,3335732,18913600,846014913
2021-04-21,14322803,829553582,3900,3321332,18699099,848252681
2021-04-22,13945641,831164518,39100,3278663,18524446,849688964
2021-04-23,9378718,824487521,14600,3291963,18566671,843054192
2021-04-26,19644439,826501527,32300,3304563,18670781,845172308
2021-04-27,7564903,821473167,75800,3365563,19015431,840488598
2021-04-28,28462624,833039988,103300,3425763,19321303,852361291
2021-04-29,19375194,835735996,78700,3270025,18573742,854309738
2021-04-30,31624943,833509886,9800,3120508,18098947,851608833
2021-05-06,19973792,837939944,37500,3153708,17913061,855853005
2021-05-07,18074746,842557485,0,3142608,17724309,860281794
2021-05-10,23098358,842293554,214500,3357108,18094812,860388366
2021-05-11,8446274,839290786,63700,3374908,18224503,857515289
2021-05-12,7144003,831882212,10200,3302808,17967275,849849487
2021-05-13,12214174,826006973,127200,3429608,18348403,844355376
2021-05-14,11786111,822449579,43000,3455708,18799051,841248630
2021-05-17,13433203,818759501,1600,3453508,18994294,837753795
2021-05-18,15433940,824569216,28800,3435608,18655352,843224568
2021-05-19,9130414,809609315,7400,3401508,18266098,827875413
2021-05-20,11519189,809287360,5400,3399808,18324965,827612325
2021-05-21,8585409,807875332,32000,3431608,18530683,826406015
2021-05-24,10534723,810050452,17200,3413008,18361983,828412435
2021-05-25,14151099,806227399,12800,3365808,18209021,824436420
2021-05-26,22809307,809656617,100500,3320708,18097859,827754476
2021-05-27,47249318,822360745,37200,3182408,18107902,840468647
2021-05-28,13525324,813272207,5900,3184808,17930469,831202676
2021-05-31,24591872,808236479,88600,3273408,18265617,826502096
2021-06-01,16500370,804338839,16600,3169308,17653045,821991884
2021-06-02,11023852,796767795,1200,2577446,14201727,810969522
2021-06-03,7485090,793374899,48300,2440746,13399696,806774595
2021-06-04,19452841,795469424,37900,2120846,11685861,807155285
2021-06-07,18829324,798778888,145535,2184081,12252694,811031582
2021-06-08,12389363,795440856,6500,1749481,9744609,805185465
2021-06-09,14579697,798683513,26700,1389481,7669935,806353448
2021-06-10,14807848,796414037,300,1389781,7782774,804196811
2021-06-11,14186552,792559992,300,1345881,7415804,799975796
2021-06-15,35155191,805597648,600,1344681,7651235,813248883
2021-06-16,22181613,800868956,399000,1706481,9641618,810510574
2021-06-17,52191325,815664700,252100,1955281,11477499,827142199
2021-06-18,47860930,828987912,190800,2145881,12553404,841541316
2021-06-21,57625445,840548411,158600,2282981,13560907,854109318
2021-06-22,26129261,840517812,345000,2626981,15420378,855938190
2021-06-23,53533477,850413105,261600,2783381,16783787,867196892
2021-06-24,29130386,849403677,493700,3237781,19297175,868700852
2021-06-25,26776148,850075682,174900,3386981,20186407,870262089
2021-06-28,26160190,846148272,174700,3519781,20766708,866914980
2021-06-29,25094520,840256917,275830,3773911,21435814,861692731
2021-06-30,67515564,839043127,498800,4249811,25796353,864839480
2021-07-01,41679203,848267025,76400,3285811,19156278,867423303
2021-07-02,24610928,855061306,6200,3265511,18841998,873903304
2021-07-05,19842769,851736704,116986,3380397,19673911,871410615
2021-07-06,16040380,847914094,73600,3446697,19990843,867904937
2021-07-07,22479298,839556240,193100,3577797,20822779,860379019
2021-07-08,36716734,851585967,213300,3789997,22171482,873757449
2021-07-09,35624178,847798193,155200,3939297,22650959,870449152
2021-07-12,29537372,843911247,73400,4012097,23310284,867221531
2021-07-13,28828686,838665858,37200,3890297,22291402,860957260
2021-07-14,13813917,827045758,124500,4014297,22761065,849806823
2021-07-15,16548708,809722284,346100,4349997,24359984,834082268
2021-07-16,16269676,807831419,166000,4491897,25244461,833075880
2021-07-19,14848937,806793382,13100,4504497,25360318,832153700
2021-07-20,36085155,820752737,173500,4656297,26727145,847479882
2021-07-21,53715039,810381408,9000,4435097,26388828,836770236
2021-07-22,81197439,821190643,169400,3736711,23802849,844993492
2021-07-23,55451201,804806524,41900,3518211,22199911,827006435
2021-07-26,45991096,810960830,38700,3496511,21573473,832534303
2021-07-27,75687491,825099636,178144,3624155,22469761,847569397
2021-07-28,40046898,822917239,15200,3475355,20643608,843560847
2021-07-29,64852404,836180860,0,3463555,21612584,857793444
2021-07-30,86133171,870147535,661700,4120555,25753469,895901004
2021-08-02,198752628,1022243873,627900,4748455,29392936,1051636809
2021-08-03,52074581,1031310909,64000,4505255,27031530,1058342439
2021-08-04,56491335,1048529229,108400,4445655,26940670,1075469899
2021-08-05,89572458,1023374418,22500,4323455,28837445,1052211863
2021-08-06,206544119,1126360999,130600,4416755,27958059,1154319058
2021-08-09,77747669,1112890977,60000,4330282,26674537,1139565514
2021-08-10,85666850,1138468846,564100,4893582,30291273,1168760119
2021-08-11,84835964,1143658873,89300,4653782,28527684,1172186557
2021-08-12,95113791,1156991151,36500,4687782,28923615,1185914766
2021-08-13,66258318,1146593435,424100,5110382,30764500,1177357935
2021-08-16,36155894,1135315396,16600,5032482,29691644,1165007040
2021-08-17,52261255,1134268636,149500,5165182,29286582,1163555218
2021-08-18,26691868,1126369644,15800,5074682,29179423,1155549067
2021-08-19,16353304,1117915100,155300,5224782,29885754,1147800854
2021-08-20,37956427,1129714892,39600,5208682,29793662,1159508554
2021-08-23,43427355,1124307371,53600,5242982,30619015,1154926386
2021-08-24,35913184,1127229057,8900,5214782,30454327,1157683384
2021-08-25,56244919,1076061880,99600,5306982,30037518,1106099398
2021-08-26,53001728,1087602770,41000,5198582,29579932,1117182702
2021-08-27,48206677,1070491092,124200,5316282,29345877,1099836969
2021-08-30,35772717,1078785780,45900,5265182,29169108,1107954888
2021-08-31,20409258,1061100453,134400,5381082,29542141,1090642594
2021-09-01,34099203,1069147832,41600,5413782,29721664,1098869496
2021-09-02,21166662,1065730325,13400,5422182,29930445,1095660770
2021-09-03,53309131,1075670765,5000,5382582,30034808,1105705573
2021-09-06,24692016,1061980824,15800,5377982,29955359,1091936183
2021-09-07,46827927,1075006005,11800,5354082,29929319,1104935324
2021-09-08,84185299,1107016340,700,5311182,30379962,1137396302
2021-09-09,42243018,1112984109,60100,5369682,30123916,1143108025
2021-09-10,53232083,1111986145,1000,5334082,29764178,1141750323
2021-09-13,30207733,1112987738,8500,5211382,28818942,1141806680
2021-09-14,27378071,1085721713,209291,5395573,29351916,1115073629
2021-09-15,21013829,1063873258,36000,5365373,28597438,1092470696
2021-09-16,18402946,1060791601,22900,5382073,28686449,1089478050
2021-09-17,27243397,1039359893,55800,5414473,28046969,1067406862
2021-09-22,15590472,1021700255,20400,5317773,26907932,1048608187
2021-09-23,18048218,1020637208,18700,5283673,27263753,1047900961
2021-09-24,9828312,1015372250,142090,5402263,27335451,1042707701
2021-09-27,16180529,1009556187,32100,5378963,27378922,1036935109
2021-09-28,11284498,1009398834,39100,5358963,27116353,1036515187
2021-09-29,14422743,1003362025,49800,5366463,26456664,1029818689
2021-09-30,7730699,998872229,11200,5331963,26393218,1025265447
2021-10-08,11488222,999281797,17200,5327663,26957975,1026239772
2021-10-11,11953190,996874045,3500,5317163,27011188,1023885233
2021-10-12,8305654,990462309,36600,5338063,26530173,1016992482
2021-10-13,29800993,1003976365,18800,5354163,26984982,1030961347
2021-10-14,6753119,999729230,2100,5356263,26888441,1026617671
2021-10-15,19114511,1008536279,9100,5365263,27094579,1035630858
2021-10-18,8061587,1011630136,25300,5390563,26898910,1038529046
2021-10-19,4609819,1009723509,7400,5378063,26836535,1036560044
2021-10-20,7288007,1005002343,11200,5384763,26600729,1031603072
2021-10-21,21361711,977281963,18700,5384863,25416555,1002698518
2021-10-22,8959683,974033176,39400,5406163,25517091,999550267
2021-10-25,32531308,978491870,16700,5208763,26356341,1004848211
2021-10-26,12095597,978224579,75600,5276063,26644119,1004868698
2021-10-27,17237195,976071631,53700,5271763,25620768,1001692399
2021-10-28,11636796,977366208,90100,5360163,25996791,1003362999
2021-10-29,9586058,974861604,10200,5297063,25955609,1000817213
2021-11-01,10914036,972051496,0,5296163,25898237,997949733
2021-11-02,28193930,982926985,65500,5354963,26399969,1009326954
2021-11-03,16386189,985678514,7600,5337563,26581063,1012259577
2021-11-04,11219443,984321236,69600,5406363,27085878,1011407114
2021-11-05,34047387,985853957,12300,5254463,27165573,1013019530
2021-11-08,23170082,986285510,7800,5238263,26610376,1012895886
2021-11-09,17912376,990799207,500,5145963,26141492,1016940699
2021-11-10,13354367,984103455,12900,5147163,26044645,1010148100
2021-11-11,18251624,986979338,11000,5143763,26078877,1013058215
2021-11-12,11870311,980412245,82600,5190863,26369584,1006781829
2021-11-15,15844856,973237187,10700,5177763,26561925,999799112
2021-11-16,33615196,976567862,123000,5274763,27323271,1003891133
2021-11-17,21421809,984649967,5800,5138263,26564819,1011214786
2021-11-18,22667671,981553077,12300,5016063,25280958,1006834035
2021-11-19,12750375,976364463,2300,4959963,25543811,1001908274
2021-11-22,25335946,962657066,38700,4874563,25640201,988297267
2021-11-23,19838898,971997736,123100,4916363,25712579,997710315
2021-11-24,21765400,973602580,5200,4778663,24753473,998356053
2021-11-25,15515900,974540093,13600,4655663,23836995,998377088
2021-11-26,18915796,969213070,73200,4540163,22791619,992004689
2021-11-29,9676274,969821091,4700,4217563,20666059,990487150
2021-11-30,11215022,967820601,40700,3986163,19611922,987432523
2021-12-01,9602839,952390047,600,3371873,16690772,969080819
2021-12-02,7779807,953036380,13800,2627537,12901207,965937587
2021-12-03,11525780,953131244,300,2220437,10968959,964100203
2021-12-06,11314005,947449230,93000,1932237,9332705,956781935
2021-12-07,8531843,945535885,16500,1753237,8503199,954039084
2021-12-08,11104655,944762866,6300,1755537,8567020,953329886
2021-12-09,36751167,952713937,48400,1742337,8641991,961355928
2021-12-10,10252056,942081353,100,1627437,8055813,950137166
2021-12-13,8376739,934076381,500,1602337,7947591,942023972
2021-12-14,7997296,934079364,22400,1557937,7665050,941744414
2021-12-15,11520569,923872061,357300,1871837,9134564,933006625
2021-12-16,13951021,927775831,605000,2471837,12136720,939912551
2021-12-17,16178945,934942052,167400,2626837,12818964,947761016
2021-12-20,5938428,934106086,177000,2741637,13269523,947375609
2021-12-21,13084257,939301809,142100,2870937,14067591,953369400
2021-12-22,13832610,934412668,339800,3169537,15689208,950101876
2021-12-23,9580824,936345610,243400,3407437,16730516,953076126
2021-12-24,9004689,927300356,165000,3570137,17279463,944579819
2021-12-27,5237566,924995244,363500,3857237,18669027,943664271
2021-12-28,5856733,925457274,88900,3642137,17700786,943158060
2021-12-29,8709339,927554023,282800,3881637,18709491,946263514
2021-12-30,8228026,926183008,118100,3927591,19048816,945231824
2021-12-31,7469260,920579046,60400,3972791,19307764,939886810
