日期,融资买入额(元),融资余额(元),融券卖出量,融券余量,融券余额(元),融资融券余额(元)
2017-07-12,31505758,312602085,23900,35082,1884605,314486690
2017-07-13,53294321,335953759,32000,41882,2149803,338103562
2017-07-14,32209810,325391306,13900,25282,1309355,326700661
2017-07-17,32458850,326826786,34100,36282,1823171,328649957
2017-07-18,22161379,329049556,12202,19484,996607,330046163
2017-07-19,16571939,312544547,30398,37082,1943097,314487644
2017-07-20,26833575,303652642,13000,27280,1445294,305097936
2017-07-21,11735916,297023728,100,12680,669884,297693612
2017-07-24,27494695,297684797,29500,38580,2049370,299734167
2017-07-25,32878906,285290512,33900,40980,2245704,287536216
2017-07-26,38430646,294724783,14018,20298,1089800,295814583
2017-07-27,27354983,302566416,1000,7254,389612,302956028
2017-07-28,21100598,297141666,19141,25295,1358342,298500008
2017-07-31,26567131,298326630,10100,15195,831926,299158556
2017-08-01,25478133,309518949,27030,33125,1792063,311311012
2017-08-02,30350099,313967289,9200,21325,1152616,315119905
2017-08-03,28335669,310799057,49117,59242,3080584,313879641
2017-08-04,17236300,307771565,9100,15325,800118,308571683
2017-08-07,13164391,309096587,14278,20403,1064833,310161420
2017-08-08,13436647,314591101,7500,13703,714063,315305164
2017-08-09,18715041,323718560,100,6303,326811,324045371
2017-08-10,14140043,321185080,21300,27503,1410079,322595159
2017-08-11,23456844,302955043,38866,41069,2152837,305107880
2017-08-14,34158473,290931587,18000,24203,1325356,292256943
2017-08-15,29159244,286030811,18800,25003,1375415,287406226
2017-08-16,30477866,279176992,19600,25744,1431109,280608101
2017-08-17,27327365,277648872,16480,23624,1300501,278949373
2017-08-18,15085064,274419896,7900,15024,817606,275237502
2017-08-21,26387340,270984761,10000,17124,946615,271931376
2017-08-22,20662843,276433615,20400,26524,1462003,277895618
2017-08-23,23348507,283714354,14741,20865,1120868,284835222
2017-08-24,14590224,283371519,12000,21324,1143180,284514699
2017-08-25,26201029,289764129,700,6924,370434,290134563
2017-08-28,28732047,293997908,20900,27024,1478213,295476121
2017-08-29,35829593,296001245,700,16324,896351,296897596
2017-08-30,53302127,308938740,8500,14624,815288,309754028
2017-08-31,63008108,331809873,25400,31523,1728406,333538279
2017-09-01,54124909,358307819,6700,13715,748290,359056109
2017-09-04,125986229,385529665,93100,99175,5822564,391352229
2017-09-05,75800494,384594438,12999,26574,1528006,386122444
2017-09-06,88550503,421920976,6691,13766,793197,422714173
2017-09-07,69611539,413397316,7700,13866,778992,414176308
2017-09-08,25403915,392543229,5100,11266,628192,393171421
2017-09-11,103785059,419177777,59494,67560,3901591,423079368
2017-09-12,164662651,452916190,22100,34560,1996185,454912375
2017-09-13,90208517,449373874,36700,44366,2449003,451822877
2017-09-14,47090574,440535280,8400,14966,808314,441343594
2017-09-15,36935570,437475975,600,6766,361981,437837956
2017-09-18,35216600,441707851,6100,12466,678150,442386001
2017-09-19,44285201,455246989,21354,29220,1544569,456791558
2017-09-20,62951180,482477377,20500,26620,1383708,483861085
2017-09-21,32731499,486636412,12800,18920,979488,487615900
2017-09-22,29293144,481491660,14600,20720,1076611,482568271
2017-09-25,24219993,475809641,12800,18920,979110,476788751
2017-09-26,19645438,483233925,0,6120,318913,483552838
2017-09-27,20708843,470550559,1500,7620,401422,470951981
2017-09-28,37180734,477542628,6700,12820,668435,478211063
2017-09-29,28166699,463444542,6100,15420,789196,464233738
2017-10-09,31174534,472930547,3500,9620,496103,473426650
2017-10-10,16889104,470978316,2400,8520,442955,471421271
2017-10-11,28955199,471791308,10400,16520,862840,472654148
2017-10-12,20086486,477676416,2400,2520,130284,477806700
2017-10-13,15611950,467656986,11000,11120,582466,468239452
2017-10-16,19132841,463969538,17600,19420,1002849,464972387
2017-10-17,11846139,461797664,0,1620,83317,461880981
2017-10-18,27329473,446892822,17762,19382,961153,447853975
2017-10-19,11851268,442370887,0,1682,83410,442454297
2017-10-20,9219253,435687961,0,1682,84436,435772397
2017-10-23,6684256,430994750,0,107,5361,431000111
2017-10-24,12107840,427775215,13250,13357,675330,428450545
2017-10-25,11876884,417698220,3000,3157,162838,417861058
2017-10-26,9527922,414560001,900,4057,208246,414768247
2017-10-27,28989102,426983475,9300,13357,669186,427652661
2017-10-30,25071344,429950142,0,3157,158892,430109034
2017-10-31,40840206,421338273,37500,37657,1973227,423311500
2017-11-01,28904747,416799723,7400,7557,396138,417195861
2017-11-02,21998063,417138152,4100,4257,221279,417359431
2017-11-03,53393875,396801372,17600,17757,951953,397753325
2017-11-06,46680891,381032232,800,895,49279,381081511
2017-11-07,45060948,384733090,4300,4395,241725,384974815
2017-11-08,42580924,397921885,0,95,5121,397927006
2017-11-09,34655633,389863036,4300,4395,240802,390103838
2017-11-10,46650945,376783856,10000,10045,557498,377341354
2017-11-13,46098605,380455228,1900,1945,107889,380563117
2017-11-14,36527446,383693853,0,1645,88419,383782272
2017-11-15,24089205,382535396,300,345,18150,382553546
2017-11-16,19225425,380300617,1600,1645,85211,380385828
2017-11-17,25164116,374264160,7300,7345,374815,374638975
2017-11-20,19852447,364838463,1600,1645,85211,364923674
2017-11-21,36762819,376403209,300,345,17429,376420638
2017-11-22,40782158,395703895,10600,10645,543427,396247322
2017-11-23,42697355,405617918,1800,1845,93486,405711404
2017-11-24,65452426,412093797,115800,115845,5282532,417376329
2017-11-27,23594914,401663676,300,15245,675811,402339487
2017-11-28,18205645,405566464,1600,16545,738734,406305198
2017-11-29,24728399,400047304,300,345,15073,400062377
2017-11-30,32192417,407497530,1600,1600,67840,407565370
2017-12-01,27044533,416431461,100,100,4256,416435717
2017-12-04,30657682,426459329,3100,3200,132640,426591969
2017-12-05,29947726,421860818,0,200,8020,421868838
2017-12-06,27958125,432763890,10800,11000,450450,433214340
2017-12-07,23413448,436010086,0,800,32720,436042806
2017-12-08,18810970,418393131,4300,4600,193430,418586561
2017-12-11,22778766,395191598,4000,4200,182532,395374130
2017-12-12,27946256,403506039,3300,3500,150500,403656539
2017-12-13,17993851,407543892,500,700,29897,407573789
2017-12-14,22712388,414903359,500,700,29442,414932801
2017-12-15,10951759,412551886,1800,2300,95864,412647750
2017-12-18,15591747,410657554,200,700,28931,410686485
2017-12-19,14863485,414412538,1800,2500,102850,414515388
2017-12-20,13010330,413191018,0,300,12399,413203417
2017-12-21,25309200,421294114,13300,13600,553520,421847634
2017-12-22,14958525,418798041,0,300,12207,418810248
2017-12-25,40962022,434886358,66920,67220,2574526,437460884
2017-12-26,15695393,440238510,0,300,11628,440250138
2017-12-27,31959200,448243416,8600,8900,345231,448588647
2017-12-28,21580352,456938031,0,4900,187523,457125554
2017-12-29,24825721,451361043,2200,2500,98975,451460018
2018-01-02,32520962,461466845,1000,2500,99450,461566295
2018-01-03,25566923,460460542,4600,6100,247416,460707958
2018-01-04,46322736,447053717,80000,81500,3475975,450529692
2018-01-05,36465114,449211577,0,3500,147245,449358822
2018-01-08,33590392,461090521,0,1500,62235,461152756
2018-01-09,26892592,464704627,2000,3500,142800,464847427
2018-01-10,31405798,474913207,0,1500,59595,474972802
2018-01-11,23266227,471037971,2000,3200,128800,471166771
2018-01-12,18488910,470547474,0,1300,51519,470598993
2018-01-15,22569447,468242589,1900,3100,119226,468361815
2018-01-16,50374175,493274392,24200,25400,928370,494202762
2018-01-17,17437939,479414197,2200,3400,127534,479541731
2018-01-18,16155903,483488645,100,1600,59536,483548181
2018-01-19,21245820,485486267,1900,2100,76860,485563127
2018-01-22,38417143,502567457,100,383,14010,502581467
2018-01-23,22397291,499266233,1800,2083,76863,499343096
2018-01-24,23659701,503024649,100,383,14228,503038877
2018-01-25,35907137,505676627,3100,3383,125475,505802102
2018-01-26,19947951,509318245,100,1683,61901,509380146
2018-01-29,26445396,513907771,1800,3483,124622,514032393
2018-01-30,9284325,510560286,0,1583,57099,510617385
2018-01-31,24518040,499518459,1900,3483,120024,499638483
2018-02-01,20811287,499041633,0,1583,52397,499094030
2018-02-02,15700471,495916308,1900,3483,116750,496033058
2018-02-05,10728028,491343215,0,1583,52682,491395897
2018-02-06,14346822,481134687,1900,3483,110237,481244924
2018-02-07,20594610,490542888,0,1583,50529,490593417
2018-02-08,12472968,484840019,19200,20783,681059,485521078
2018-02-09,11035054,476023085,7700,9283,298634,476321719
2018-02-12,19750618,470248824,30300,31883,1083384,471332208
2018-02-13,12919751,459620670,9100,30183,1014451,460635121
2018-02-14,6461871,449570900,4300,7483,251129,449822029
2018-02-22,16475545,449675275,6300,7883,269599,449944874
2018-02-23,14126374,451919819,9400,10983,372763,452292582
2018-02-26,46871887,457231630,30800,32383,1159959,458391589
2018-02-27,29754130,451973133,9400,34283,1204019,453177152
2018-02-28,23799086,447302559,5100,6683,235843,447538402
2018-03-01,21420129,448762141,16400,17983,640195,449402336
2018-03-02,22185657,450463754,14500,14583,517113,450980867
2018-03-05,17198468,447287832,17000,17083,602347,447890179
2018-03-06,41700746,453559103,22200,22329,812329,454371432
2018-03-07,19395708,445779368,26400,26501,946086,446725454
2018-03-08,16648873,449683795,200,1399,49986,449733781
2018-03-09,30450086,452013032,12700,12899,469911,452482943
2018-03-12,54211584,448705930,25800,25999,978082,449684012
2018-03-13,30156865,454000129,5600,10799,399347,454399476
2018-03-14,22038756,450523783,27400,27599,1017299,451541082
2018-03-15,30293745,452197663,24400,25914,932904,453130567
2018-03-16,17543435,457656120,26300,27814,991847,458647967
2018-03-19,24976413,470152533,24400,25914,910359,471062892
2018-03-20,21767051,468523560,25800,27314,959541,469483101
2018-03-21,16103243,468348675,24500,27914,968616,469317291
2018-03-22,12704187,468014098,22749,24263,831978,468846076
2018-03-23,19052913,451762775,30200,31763,1012604,452775379
2018-03-26,16195157,451570165,22300,27663,894345,452464510
2018-03-27,18721726,450517142,24415,29778,989523,451506665
2018-03-28,16238214,447153334,27600,32978,1078381,448231715
2018-03-29,10653473,444390571,26300,31678,1050126,445440697
2018-03-30,35811638,457027300,101400,106778,3647536,460674836
2018-04-02,20514215,457573815,28900,34278,1167509,458741324
2018-04-03,14890555,458966465,24200,25778,863821,459830286
2018-04-04,11795761,454353914,26400,27978,923834,455277748
2018-04-09,8638956,446962272,13199,13477,439215,447401487
2018-04-10,10718751,432291770,26400,26677,880608,433172378
2018-04-11,14510485,436855930,24300,24577,819889,437675819
2018-04-12,10210467,427393867,24444,24721,822468,428216335
2018-04-13,5254384,422888150,24300,24521,816549,423704699
2018-04-16,9842031,423789375,30300,30521,993764,424783139
2018-04-17,10900086,421952092,25300,25521,816672,422768764
2018-04-18,14080754,424611037,13700,13921,443523,425054560
2018-04-19,9491687,422871215,25443,25664,833823,423705038
2018-04-20,8868441,417805522,25145,25409,800892,418606414
2018-04-23,15213980,421771094,19800,20009,609274,422380368
2018-04-24,15120619,424006576,10600,10809,336700,424343276
2018-04-25,7925745,415657234,13400,13609,431950,416089184
2018-04-26,8151898,412721087,17800,18009,558639,413279726
2018-04-27,6194255,408740744,6200,6409,200922,408941666
2018-05-02,11869634,414591059,1500,1583,49105,414640164
2018-05-03,9876010,409245455,1100,1883,60350,409305805
2018-05-04,8469545,409105360,800,1583,50165,409155525
2018-05-07,39751583,428093018,24919,25702,853563,428946581
2018-05-08,28768481,428420437,1100,3283,109127,428529564
2018-05-09,22174275,424422925,0,1083,35577,424458502
2018-05-10,17940394,424904893,0,1083,35587,424940480
2018-05-11,45589343,422024167,81500,81883,2847891,424872058
2018-05-14,55261090,436746475,11900,12483,428666,437175141
2018-05-15,34841435,448409448,0,5383,186252,448595700
2018-05-16,47601824,449659257,26200,31583,1106037,450765294
2018-05-17,28738700,445328071,1900,2283,78147,445406218
2018-05-18,42972947,465121236,27400,27783,930731,466051967
2018-05-21,41145493,475600980,3100,20283,687188,476288168
2018-05-22,28216996,475102756,800,17983,617177,475719933
2018-05-23,25236430,477669039,2500,10483,348350,478017389
2018-05-24,23578543,469377629,76200,84783,2897883,472275512
2018-05-25,37178735,478872210,3100,11683,386240,479258450
2018-05-28,17904138,478126324,0,8583,281780,478408104
2018-05-29,27461241,483132169,3600,11883,379781,483511950
2018-05-30,16195412,474481522,300,8583,262897,474744419
2018-05-31,12746158,469144997,3100,11383,356402,469501399
2018-06-01,8429641,460446709,0,8283,259506,460706215
2018-06-04,15391354,458380892,3000,11283,349886,458730778
2018-06-05,15144491,457603982,400,8683,278290,457882272
2018-06-06,18436315,458209250,1100,9383,299975,458509225
2018-06-07,14938067,456219319,1900,10183,325856,456545175
2018-06-08,14545653,456301902,0,8283,260666,456562568
2018-06-11,8183323,449234508,3400,11683,365211,449599719
2018-06-12,9353530,445087195,6500,14783,467438,445554633
2018-06-13,11101554,443994278,3400,11683,360187,444354465
2018-06-14,6077506,444560873,1100,10883,336285,444897158
2018-06-15,13285895,442991211,16000,24283,732375,443723586
2018-06-19,15455241,424103470,16760,27043,739085,424842555
2018-06-20,9538952,420370665,6200,24383,676872,421047537
2018-06-21,11227134,417643506,13300,31983,841793,418485299
2018-06-22,8789895,413260769,29100,48883,1325218,414585987
2018-06-25,6577116,411838535,3400,32283,875838,412714373
2018-06-26,9934101,412921214,200,29083,801818,413723032
2018-06-27,6897722,409522822,3400,32483,891658,410414480
2018-06-28,7516491,407199748,3200,31383,853931,408053679
2018-06-29,9929553,401940603,6500,36883,1040838,402981441
2018-07-02,11058007,402313681,1100,35483,977557,403291238
2018-07-03,12429330,403868578,16300,50683,1419631,405288209
2018-07-04,7182254,400683220,1800,45183,1238014,401921234
2018-07-05,7213013,398212087,7800,51883,1380088,399592175
2018-07-06,7580401,396546189,1100,47383,1272234,397818423
2018-07-09,10494479,396969180,2700,48283,1332611,398301791
2018-07-10,9932528,398002441,1100,47083,1307966,399310407
2018-07-11,10092603,395598935,3300,49283,1336555,396935490
2018-07-12,21668428,396552584,5800,49683,1399073,397951657
2018-07-13,13482457,395165666,1500,45383,1271632,396437298
2018-07-16,9016320,397912058,1900,45383,1273447,399185505
2018-07-17,9288762,393075425,9000,52483,1466900,394542325
2018-07-18,57936466,409990812,84636,135619,4018391,414009203
2018-07-19,24391715,407847380,4100,55083,1599059,409446439
2018-07-20,11233327,397541142,0,51683,1506043,399047185
2018-07-23,19477685,396526626,12400,64083,1879554,398406180
2018-07-24,22319343,398652437,0,60683,1792576,400445013
2018-07-25,21592860,394111318,5000,64183,1882487,395993805
2018-07-26,17678087,396429679,900,60883,1752213,398181892
2018-07-27,5989768,389776495,3400,63383,1819726,391596221
2018-07-30,8932031,391396186,0,59183,1680205,393076391
2018-07-31,6396213,389889524,5700,58083,1653042,391542566
2018-08-01,10933215,391010837,0,54683,1543154,392553991
2018-08-02,12595082,391492165,12900,65783,1795218,393287383
2018-08-03,7635421,391996056,800,53683,1449441,393445497
2018-08-06,5662233,391568632,1900,53583,1441383,393010015
2018-08-07,8057627,391366625,2100,55683,1537964,392904589
2018-08-08,5366818,390306866,2700,56483,1536338,391843204
2018-08-09,7261869,386904497,3100,49583,1371962,388276459
2018-08-10,3888658,383448898,2500,49083,1360581,384809479
2018-08-13,6420526,383610515,5700,51083,1413977,385024492
2018-08-14,6577111,386019058,10300,56983,1565323,387584381
2018-08-15,7346282,384926717,5400,58783,1577148,386503865
2018-08-16,3316042,384170728,2500,53583,1434417,385605145
2018-08-17,3649425,380826510,6900,51983,1381708,382208218
2018-08-20,5113309,380760487,5300,52983,1424713,382185200
2018-08-21,5554937,378048105,4400,51083,1388947,379437052
2018-08-22,7091816,378841438,9700,54383,1448763,380290201
2018-08-23,6264885,380451590,2200,48683,1306652,381758242
2018-08-24,8965767,381566146,4000,51983,1373391,382939537
2018-08-27,5584541,380102353,2700,48383,1305373,381407726
2018-08-28,7040830,382054938,1600,47283,1279951,383334889
2018-08-29,4060917,380068114,12300,57983,1560323,381628437
2018-08-30,3662538,379286201,600,54583,1451908,380738109
2018-08-31,2973093,374044503,4000,55683,1471702,375516205
2018-09-03,4876099,370851609,4090,48371,1272157,372123766
2018-09-04,3854797,363279700,4100,45471,1218623,364498323
2018-09-05,3601404,361669551,2300,45271,1195154,362864705
2018-09-06,5385176,362786263,11800,53771,1412564,364198827
2018-09-07,4255452,356821175,3100,45071,1179057,358000232
2018-09-10,5696164,349963182,23600,65871,1638211,351601393
2018-09-11,2526702,347222233,1300,43271,1081342,348303575
2018-09-12,2260237,344917266,19200,60571,1531235,346448501
2018-09-13,4579951,343701861,2700,55171,1401343,345103204
2018-09-14,3211123,340418634,6500,60571,1529418,341948052
2018-09-17,2574929,339070404,3500,50671,1254108,340324512
2018-09-18,3957016,338757701,2400,50371,1263304,340021005
2018-09-19,8079897,341321823,5300,42471,1070694,342392517
2018-09-20,3303419,339065398,2800,41071,1041150,340106548
2018-09-21,6725168,338324688,10700,48771,1255854,339580542
2018-09-25,5715689,337461484,300,39871,1008736,338470220
2018-09-26,6208336,334806645,6400,44071,1115878,335922523
2018-09-27,3923963,330558223,5000,41971,1039202,331597425
2018-09-28,4434335,325084296,3800,39471,989932,326074228
2018-10-08,4987546,324341342,23700,43271,1065332,325406674
2018-10-09,3526491,325419655,4000,24271,595854,326015509
2018-10-10,2872706,325982793,3200,22871,561711,326544504
2018-10-11,9946586,320420027,14700,34271,757732,321177759
2018-10-12,7332800,312921844,37100,61671,1295091,314216935
2018-10-15,14041655,313541001,23300,50871,1136967,314677968
2018-10-16,6926470,313619743,15500,41871,930374,314550117
2018-10-17,5345386,307057750,33600,59971,1397324,308455074
2018-10-18,6355968,309387078,12500,53971,1238635,310625713
2018-10-19,5351156,308454957,8700,45771,1065549,309520506
2018-10-22,9802871,304812875,47200,83571,2085097,306897972
2018-10-23,8138028,304610606,10764,47095,1153828,305764434
2018-10-24,8309123,305399692,20100,56395,1361940,306761632
2018-10-25,6500322,304827026,10564,46859,1151325,305978351
2018-10-26,4109800,304118677,8500,45559,1102072,305220749
2018-10-29,4003878,304972761,13000,49359,1174744,306147505
2018-10-30,12638363,294274780,40200,75759,1943976,296218756
2018-10-31,15269232,285391145,13700,48751,1325540,286716685
2018-11-01,16768242,275877929,14900,42751,1190616,277068545
2018-11-02,23308082,273566834,59200,87051,2560170,276127004
2018-11-05,22490693,282527003,9800,62851,1813252,284340255
2018-11-06,17085261,268541379,17900,69432,2005890,270547269
2018-11-07,16732408,261368726,44633,91765,2746527,264115253
2018-11-08,14438027,261840349,11400,60146,1764684,263605033
2018-11-09,5837590,258621579,14700,62546,1831347,260452926
2018-11-12,16849881,261214525,15200,65718,1971540,263186065
2018-11-13,12655894,254269960,9000,59517,1803366,256073326
2018-11-14,17738905,260957808,7700,60717,1800866,262758674
2018-11-15,10862156,249923511,8000,61017,1851866,251775377
2018-11-16,18693150,255461953,9700,65017,2001223,257463176
2018-11-19,8797248,251258973,7500,38317,1167902,252426875
2018-11-20,15628742,254605564,8300,37206,1094600,255700164
2018-11-21,15613100,253430937,45400,74206,2297418,255728355
2018-11-22,24841113,262980975,10000,39406,1181392,264162367
2018-11-23,12886306,260615177,13234,43240,1279904,261895081
2018-11-26,23315630,264323460,40300,63540,1797547,266121007
2018-11-27,7304183,258332234,19985,42125,1206881,259539115
2018-11-28,9389245,256926182,17500,41451,1222390,258148572
2018-11-29,5686427,253109310,16573,36824,1059795,254169105
2018-11-30,5267121,249006118,16600,43956,1301538,250307656
2018-12-03,14961450,251325584,13300,40256,1204459,252530043
2018-12-04,23344860,264520645,5835,38591,1180884,265701529
2018-12-05,19750263,274205293,13960,40116,1195457,275400750
2018-12-06,11672687,276471657,15900,38156,1104616,277576273
2018-12-07,5815201,269498002,14000,41756,1227627,270725629
2018-12-10,10477969,267597775,16161,41817,1206002,268803777
2018-12-11,3630278,264230293,4900,35256,1034764,265265057
2018-12-12,5006573,261934632,10300,42756,1245054,263179686
2018-12-13,6540262,260212407,8100,39856,1165788,261378195
2018-12-14,5348036,255752900,10700,31156,891061,256643961
2018-12-17,5395519,253244665,8400,32156,903262,254147927
2018-12-18,4594040,250906758,15300,34156,967298,251874056
2018-12-19,3920188,251969733,12234,32590,910239,252879972
2018-12-20,2800147,252563139,11400,30556,860457,253423596
2018-12-21,4085964,251836818,10400,29456,826241,252663059
2018-12-24,11516969,254035329,54694,75050,2225232,256260561
2018-12-25,8064863,247636721,16762,35818,1070958,248707679
2018-12-26,8871685,250491667,16423,35679,1068586,251560253
2018-12-27,5100013,249608104,3400,33903,1006580,250614684
2018-12-28,7190852,246328260,6900,25459,730164,247058424
2019-01-02,4897993,243967191,15200,33159,964927,244932118
2019-01-03,7885760,243077184,8600,30059,877722,243954906
2019-01-04,5586105,240657167,10712,30671,901114,241558281
2019-01-07,10408254,240312310,8500,29225,860677,241172987
2019-01-08,5009781,241825671,8500,29225,854247,242679918
2019-01-09,27232832,245248105,15700,36525,1104881,246352986
2019-01-10,13535655,245948574,5600,26725,811371,246759945
2019-01-11,16854087,254836594,12100,31525,948903,255785497
2019-01-14,11979946,255718828,2300,26225,762885,256481713
2019-01-15,10424714,253077781,10200,27225,786802,253864583
2019-01-16,9015277,258537822,4400,26625,769462,259307284
2019-01-17,5666481,256119901,10500,33225,934619,257054520
2019-01-18,5430880,252613366,4200,27091,773990,253387356
2019-01-21,4610885,246800618,5000,28325,811794,247612412
2019-01-22,7941505,250931708,2500,25525,728229,251659937
2019-01-23,4083749,250097298,5566,25991,741264,250838562
2019-01-24,10835084,252560460,9600,30225,873200,253433660
2019-01-25,8081822,245232985,7200,28425,810681,246043666
2019-01-28,4240679,242620831,8189,26914,769471,243390302
2019-01-29,9839197,243579391,15000,30653,842038,244421429
2019-01-30,2132992,238912184,8000,24127,665664,239577848
2019-01-31,4141402,238809198,8200,22527,615212,239424410
2019-02-01,2518834,231651574,2800,15227,427422,232078996
2019-02-11,8615749,227993735,500,12927,384061,228377796
2019-02-12,8745326,228495868,1700,9237,276648,228772516
2019-02-13,21036439,226991096,7500,15937,502812,227493908
2019-02-14,14261189,226944864,2000,13337,425317,227370181
2019-02-15,11871446,226819593,3200,15037,474868,227294461
2019-02-18,19979699,229026421,14100,26437,857616,229884037
2019-02-19,11274337,221328165,4300,25937,828168,222156333
2019-02-20,8617576,221867983,5100,26637,845192,222713175
2019-02-21,23676511,224562941,6100,23837,766598,225329539
2019-02-22,13412517,217540535,3700,18737,615698,218156233
2019-02-25,23874500,213390047,14400,29437,1014399,214404446
2019-02-26,16990020,210327983,4100,22837,784679,211112662
2019-02-27,17673254,213171036,5000,19937,663902,213834938
2019-02-28,7032855,213061141,7900,22537,762877,213824018
2019-03-01,7400581,215022649,5300,20137,682846,215705495
2019-03-04,19918978,218633150,4385,20622,698467,219331617
2019-03-05,11299235,214937655,3400,19422,671225,215608880
2019-03-06,22347843,220186953,5700,20722,722576,220909529
2019-03-07,24190111,226415118,4200,19222,672193,227087311
2019-03-08,45792572,247981774,5900,20922,697540,248679314
2019-03-11,12555089,239977204,3400,20722,711594,240688798
2019-03-12,26716409,237347730,3300,20422,720897,238068627
2019-03-13,20793511,242839612,3600,19022,651503,243491115
2019-03-14,16046309,243800052,4998,20420,697751,244497803
2019-03-15,11152610,241135843,3600,19020,651055,241786898
2019-03-18,22000267,232891949,5000,20520,727844,233619793
2019-03-19,24008020,244828755,3600,19120,665567,245494322
2019-03-20,15929064,240640786,5000,20520,719636,241360422
2019-03-21,19654993,248531014,3600,19120,669774,249200788
2019-03-22,29200044,256702464,5000,20520,735232,257437696
2019-03-25,22884956,246600226,0,18620,647976,247248202
2019-03-26,12329766,245680331,5300,20820,706631,246386962
2019-03-27,7736636,240584740,3300,18820,640821,241225561
2019-03-28,13074090,241011017,6800,22220,743481,241754498
2019-03-29,13997966,239880450,3400,18820,657759,240538209
2019-04-01,18404424,231379606,5300,20920,753748,232133354
2019-04-02,21641566,234643017,3200,18820,679778,235322795
2019-04-03,16280255,233758676,5300,20820,750145,234508821
2019-04-04,29739219,242470690,3300,18420,673803,243144493
2019-04-08,22394310,243694043,5400,17420,611965,244306008
2019-04-09,11691071,243097246,3300,15420,544327,243641573
2019-04-10,11226187,236683519,8500,19320,682382,237365901
2019-04-11,9963095,237438640,4600,18920,655767,238094407
2019-04-12,3129965,232509433,5000,18120,631120,233140553
2019-04-15,9614301,234906947,5800,19120,656198,235563145
2019-04-16,8866308,236287791,2400,17420,610571,236898362
2019-04-17,14014864,238140742,5000,20220,715788,238856530
2019-04-18,10238338,241030358,1900,19020,663608,241693966
2019-04-19,24519035,255946989,5900,21220,744823,256691812
2019-04-22,18892760,250424822,3700,20020,674474,251099296
2019-04-23,5020056,246958472,5900,22220,750369,247708841
2019-04-24,9713713,248820120,6700,21920,742430,249562550
2019-04-25,10059080,252366700,6400,18120,593973,252960673
2019-04-26,21147912,244275976,10300,20520,626476,244902452
2019-04-29,5365565,237111196,6700,20920,651240,237762436
2019-04-30,7173566,237914459,3300,15220,460862,238375321
2019-05-06,11948798,234560953,7800,15620,436423,234997376
2019-05-07,10491203,238789340,14000,21720,608160,239397500
2019-05-08,8960695,241559250,6300,14520,397848,241957098
2019-05-09,2330682,238266880,7100,16320,447820,238714700
2019-05-10,9013299,239682812,7500,14920,417312,240100124
2019-05-13,10047239,245483750,5500,13020,354405,245838155
2019-05-14,8308205,249268465,15200,19820,532167,249800632
2019-05-15,13098057,256103804,3200,8935,242585,256346389
2019-05-16,14591766,260806001,7200,12135,332620,261138621
2019-05-17,15197254,265557085,6600,12235,322882,265879967
2019-05-20,13028794,265906028,9900,15735,403917,266309945
2019-05-21,5876705,264077041,4800,15435,404397,264481438
2019-05-22,5249696,261948049,5000,14535,377183,262325232
2019-05-23,2351758,259886659,10400,17035,437800,260324459
2019-05-24,5390692,262443691,4300,13035,332653,262776344
2019-05-27,5718875,261151495,5900,10735,282008,261433503
2019-05-28,8764786,262597751,5400,12235,319823,262917574
2019-05-29,9496406,266802240,6200,11135,289955,267092195
2019-05-30,2729631,264054629,11900,17435,448603,264503232
2019-05-31,4260878,264702147,3200,14835,382891,265085038
2019-06-03,4873716,264215288,9100,16635,421365,264636653
2019-06-04,5297656,266559243,10400,20535,515429,267074672
2019-06-05,8411227,271459206,7700,26735,657948,272117154
2019-06-06,8914393,274476872,6600,26235,616523,275093395
2019-06-10,10366594,280030659,7400,23735,559909,280590568
2019-06-11,22439356,290324739,5900,18035,448170,290772909
2019-06-12,9096735,285099787,10377,23612,578494,285678281
2019-06-13,7683750,286913291,4062,20574,508178,287421469
2019-06-14,7411893,282436439,5300,20674,499897,282936336
2019-06-17,13992191,292158840,13200,29874,707715,292866555
2019-06-18,7769770,291410871,2200,18174,435267,291846138
2019-06-19,14587740,294406110,16400,30874,755796,295161906
2019-06-20,15321564,293803566,4800,11974,301625,294105191
2019-06-21,18010821,289362937,7500,14274,363987,289726924
2019-06-24,27417940,291732179,8900,17374,469967,292202146
2019-06-25,19843038,292932728,9000,17074,457071,293389799
2019-06-26,11362814,294643734,10300,18074,483480,295127214
2019-06-27,15146560,297402408,13000,26874,715923,298118331
2019-06-28,13524703,298139558,7100,24674,642264,298781822
2019-07-01,26407348,298142522,9500,22374,611258,298753780
2019-07-02,17574423,299927527,4700,16774,451724,300379251
2019-07-03,10529035,299024969,3900,15874,417486,299442455
2019-07-04,7584365,302396922,2000,15474,404490,302801412
2019-07-05,8699328,303505035,6700,14174,371217,303876252
2019-07-08,8926264,302043875,12600,17774,447372,302491247
2019-07-09,10547154,306342787,11800,17474,442442,306785229
2019-07-10,7978084,306421989,7600,23674,587825,307009814
2019-07-11,6780651,302048255,2700,22374,559574,302607829
2019-07-12,5648215,302112663,9500,18374,463209,302575872
2019-07-15,14483041,303889993,14500,22974,575499,304465492
2019-07-16,8479552,302351591,6100,23574,591943,302943534
2019-07-17,7056150,299420694,3400,20574,514761,299935455
2019-07-18,7924366,300562158,11300,19674,480833,301042991
2019-07-19,6170418,299989427,4500,19674,482406,300471833
2019-07-22,5137071,299442221,15900,23174,559189,300001410
2019-07-23,3705568,298261265,8300,17474,426715,298687980
2019-07-24,36277116,322423705,8600,26074,700348,323124053
2019-07-25,76712047,342120449,3700,24774,732072,342852521
2019-07-26,103079980,342514321,14200,32474,990457,343504778
2019-07-29,108267389,369325811,7400,34574,1070065,370395876
2019-07-30,78734537,374738416,4300,34174,1077848,375816264
2019-07-31,91739856,388906374,5700,22674,756178,389662552
2019-08-01,85742282,360487951,5300,16074,533496,361021447
2019-08-02,94238928,340466493,20100,30474,1002595,341469088
2019-08-05,65920586,334047440,5900,23474,746473,334793913
2019-08-06,70680740,333330247,13800,27378,868430,334198677
2019-08-07,50064235,324155023,7400,21578,654461,324809484
2019-08-08,25846391,301204180,8643,25421,785763,301989943
2019-08-09,99146195,300841601,11600,28921,977529,301819130
2019-08-12,118135978,336582929,4695,23516,830585,337413514
2019-08-13,121015833,328672531,14700,32016,1223012,329895543
2019-08-14,148844755,375665668,6600,28482,1084880,376750548
2019-08-15,90859545,368712204,10300,30582,1183830,369896034
2019-08-16,74971927,359003104,5700,28582,1080686,360083790
2019-08-19,129526630,390848877,8900,26382,1032328,391881205
2019-08-20,49535694,357986701,4600,27082,1039407,359026108
2019-08-21,78827998,368660521,5400,27582,1089490,369750011
2019-08-22,109420092,393074204,11000,29582,1242444,394316648
2019-08-23,101928817,396811187,7700,29782,1192769,398003956
2019-08-26,125244043,456110910,5600,31082,1206293,457317203
2019-08-27,72719816,456370327,6500,33582,1306004,457676331
2019-08-28,58695987,451708868,4600,32682,1248453,452957321
2019-08-29,52826891,434850621,6400,27282,1042173,435892794
2019-08-30,44052300,421492820,7100,27682,1019528,422512348
2019-09-02,33195926,395470666,8500,24482,924195,396394861
2019-09-03,58904563,400636957,9300,26482,1031738,401668695
2019-09-04,49852193,401790498,10200,25182,962456,402752954
2019-09-05,95285312,428452049,11500,27082,1046719,429498768
2019-09-06,54982337,423812257,6000,26882,1032806,424845063
2019-09-09,78946516,393842471,8500,31182,1278462,395120933
2019-09-10,59083768,390975927,8300,34582,1359073,392335000
2019-09-11,53187992,399676304,5000,27382,1033122,400709426
2019-09-12,29222068,397461349,10300,33182,1269543,398730892
2019-09-16,102807401,370144621,5900,33082,1358016,371502637
2019-09-17,108509695,354430204,4100,29082,1244419,355674623
2019-09-18,113872703,385623968,6600,27682,1161260,386785228
2019-09-19,101435999,380909275,6200,27883,1236054,382145329
2019-09-20,87945299,366755843,3900,25083,1115692,367871535
2019-09-23,62512670,364160832,4000,24083,1071453,365232285
2019-09-24,59864758,353703115,4400,23083,1020037,354723152
2019-09-25,50021997,340969803,5600,24483,1058156,342027959
2019-09-26,58343435,329556360,11300,30283,1195270,330751630
2019-09-27,46956446,318079873,5500,29483,1217648,319297521
2019-09-30,42562380,315696964,8100,26083,1062882,316759846
2019-10-08,60419124,341412573,9300,31183,1242331,342654904
2019-10-09,31986156,330082086,6700,22583,898126,330980212
2019-10-10,69366704,361142629,6200,20883,853070,361995699
2019-10-11,46035748,368946168,4300,18383,731092,369677260
2019-10-14,81720481,356205136,19900,34483,1508631,357713767
2019-10-15,75527599,362942358,3900,34383,1441679,364384037
2019-10-16,37902313,361195469,3900,31683,1310092,362505561
2019-10-17,51255121,340942545,6000,33883,1406145,342348690
2019-10-18,42637286,320937742,4300,30983,1247066,322184808
2019-10-21,27391767,322958289,4100,27340,1071728,324030017
2019-10-22,32502301,322476573,4300,28740,1151037,323627610
2019-10-23,32730835,324639955,4200,27240,1080339,325720294
2019-10-24,31472276,321022356,4300,20240,800897,321823253
2019-10-25,40567186,332270518,16100,32240,1318938,333589456
2019-10-28,57170042,345198441,4300,31640,1300088,346498529
2019-10-29,50368811,324784732,4400,22440,874038,325658770
2019-10-30,36903833,327193723,9800,27240,1036754,328230477
2019-10-31,32332203,338781034,4300,22240,834001,339615035
2019-11-01,29285828,349927797,7500,24140,905975,350833772
2019-11-04,53792653,354540807,4500,22440,850700,355391507
2019-11-05,138069034,397086079,7500,21840,884301,397970380
2019-11-06,76431017,373450754,4900,19440,780905,374231659
2019-11-07,122202926,428038370,4700,20240,781872,428820242
2019-11-08,41954391,415075216,5700,19740,763149,415838365
2019-11-11,44517952,385330014,5400,20539,749263,386079277
2019-11-12,22498962,371956570,11600,24839,900662,372857232
2019-11-13,30573199,367838256,6500,29939,1078403,368916659
2019-11-14,42639568,370924789,4800,33339,1254880,372179669
2019-11-15,47723707,376771471,3000,29739,1098261,377869732
2019-11-18,25412513,377874278,3100,29439,1082766,378957044
2019-11-19,54129806,392662620,2000,28274,1060558,393723178
2019-11-20,32439355,386198786,3400,28674,1055490,387254276
2019-11-21,27926379,393014204,800,21474,783802,393798006
2019-11-22,49225834,380269088,13900,30774,1128791,381397879
2019-11-25,47993356,400562652,1500,23874,839410,401402062
2019-11-26,25481294,398282753,6400,19874,710695,398993448
2019-11-27,43620615,394082440,3700,17174,630629,394713069
2019-11-28,65887901,401266292,5700,20474,767570,402033862
2019-11-29,36277468,397225655,4200,20374,758116,397983771
2019-12-02,19621349,387568023,1800,20374,763821,388331844
2019-12-03,26616621,384677859,1800,18674,701582,385379441
2019-12-04,63438699,397936494,3700,20474,791729,398728223
2019-12-05,66951099,409448975,5200,21574,850231,410299206
2019-12-06,69262573,423656459,1800,21274,845003,424501462
2019-12-09,32248573,410853458,7100,24874,989487,411842945
2019-12-10,44117040,416283040,2100,24274,990379,417273419
2019-12-11,62608020,411773795,4600,27174,1059515,412833310
2019-12-12,44801818,417440343,1800,27474,1056376,418496719
2019-12-13,75447491,425224729,3900,23974,961118,426185847
2019-12-16,122506686,457954945,9700,28674,1201441,459156386
2019-12-17,99963801,462485326,3700,22674,958657,463443983
2019-12-18,61746445,452716961,3200,24374,1014202,453731163
2019-12-19,38641679,455059057,4000,26874,1112315,456171372
2019-12-20,66864296,484620037,5500,30074,1227019,485847056
2019-12-23,37601812,456936607,2200,28374,1118219,458054826
2019-12-24,63641589,459768439,1900,28174,1169222,460937661
2019-12-25,104361976,501410450,1500,28174,1161050,502571500
2019-12-26,64762231,492316992,2600,29074,1205408,493522400
2019-12-27,94032689,515514139,4500,30069,1221102,516735241
2019-12-30,61557070,531854452,1500,29569,1204641,533059093
2019-12-31,37541286,513824817,1500,25869,1053903,514878720
2020-01-02,52974862,508960798,5500,28969,1208586,510169384
2020-01-03,51481221,509870279,2100,26769,1126440,510996719
2020-01-06,114780959,520568314,7800,28569,1233324,521801638
2020-01-07,56194874,520008508,5800,31769,1361619,521370127
2020-01-08,56841757,514838220,2000,24469,1018644,515856864
2020-01-09,41737485,503202935,3000,22069,933078,504136013
2020-01-10,42738103,490247082,4300,23869,1005601,491252683
2020-01-13,53634459,443820691,5600,22769,971098,444791789
2020-01-14,91776648,443511911,5500,23669,1020607,444532518
2020-01-15,49257580,438604016,2200,20769,876244,439480260
2020-01-16,116144826,463700332,3500,23269,1079914,464780246
2020-01-17,96781975,420679327,9500,28269,1293590,421972917
2020-01-20,93928025,430403838,4100,28869,1366081,431769919
2020-01-21,63029129,431882856,1800,28169,1309295,433192151
2020-01-22,103427077,447749147,4100,22669,1112141,448861288
2020-01-23,104244875,454393635,11100,26169,1216859,455610494
2020-02-03,7825950,432536481,0,24169,1011473,433547954
2020-02-04,77304350,422057644,0,23569,1002154,423059798
2020-02-05,74825717,421281652,0,19869,845029,422126681
2020-02-06,78858471,427795742,0,19869,862712,428658454
2020-02-07,54368703,426377046,0,19569,839706,427216752
2020-02-10,92459298,450129596,7400,16869,749827,450879423
2020-02-11,52889052,445488320,10300,18034,794398,446282718
2020-02-12,82416498,448622254,5200,21334,975817,449598071
2020-02-13,92450010,442839365,7000,26434,1205655,444045020
2020-02-14,79977075,426099254,2400,14234,654764,426754018
2020-02-17,101277194,435551709,10000,24034,1157718,436709427
2020-02-18,115067947,458857491,500,18934,914134,459771625
2020-02-19,85883620,424065956,7300,19034,878609,424944565
2020-02-20,76327335,415137624,5800,17734,832079,415969703
2020-02-21,137438669,444862266,6900,20534,991792,445854058
2020-02-24,191112347,495211053,1200,21634,1102469,496313522
2020-02-25,138564454,467468161,2500,19034,969973,468438134
2020-02-26,102268133,463006508,6100,19146,911350,463917858
2020-02-27,61235788,445331692,6300,22446,1064838,446396530
2020-02-28,39134677,405003312,2200,15179,673796,405677108
2020-03-02,59410774,422032747,8800,21779,993340,423026087
2020-03-03,54675782,402439188,6600,22679,1065686,403504874
2020-03-04,41894686,417914620,4200,24179,1127950,419042570
2020-03-05,34672100,401835980,2000,22279,1040207,402876187
2020-03-06,27488292,402643787,300,16679,764732,403408519
2020-03-09,26989042,394068316,0,13879,605957,394674273
2020-03-10,38097862,389078580,2000,15879,709633,389788213
2020-03-11,36404107,397434504,9600,23479,1014058,398448562
2020-03-12,34723344,391100753,3400,19379,800353,391901106
2020-03-13,95197278,426831912,5400,13979,568945,427400857
2020-03-16,39547182,355956393,13000,21779,813228,356769621
2020-03-17,18464709,339830374,3300,19679,732059,340562433
2020-03-18,21384101,338253939,11600,23379,857542,339111481
2020-03-19,19837322,333215786,4400,16479,611865,333827651
2020-03-20,28720297,343859074,11600,22879,854302,344713376
2020-03-23,21544291,342780180,4000,21379,741638,343521818
2020-03-24,70098254,389431196,8000,20279,719499,390150695
2020-03-25,86351168,352896481,8700,25379,912629,353809110
2020-03-26,19280086,353470620,7300,23979,843581,354314201
2020-03-27,27992575,362859823,5800,20279,713010,363572833
2020-03-30,25279843,370621769,6100,16279,553649,371175418
2020-03-31,13228824,367652657,10200,20379,694924,368347581
2020-04-01,24619389,371373227,9500,20079,699352,372072579
2020-04-02,40842428,350302658,6100,16979,606999,350909657
2020-04-03,17543742,347703827,4300,14879,521807,348225634
2020-04-07,33397642,352364483,4200,15179,547810,352912293
2020-04-08,23709997,352253905,10800,21379,776485,353030390
2020-04-09,21753633,352650300,4200,16679,606115,353256415
2020-04-10,20579444,353303096,5400,16579,586399,353889495
2020-04-13,16570892,350921029,6300,12679,446808,351367837
2020-04-14,24274271,359875302,5600,16079,581577,360456879
2020-04-15,33842819,369284996,6000,20079,727462,370012458
2020-04-16,17323130,367258338,5800,19079,692377,367950715
2020-04-17,48610890,363477346,5500,21179,798448,364275794
2020-04-20,29842297,369477087,0,17479,662105,370139192
2020-04-21,19883683,372435140,3600,19979,742420,373177560
2020-04-22,7833236,361681270,5200,19279,716793,362398063
2020-04-23,6203468,357900423,7900,19179,703486,358603909
2020-04-24,17109052,358521834,6500,15779,583665,359105499
2020-04-27,8490444,342240899,3800,18479,675592,342916491
2020-04-28,14154446,337690561,4300,11179,400544,338091105
2020-04-29,6718140,329018968,12000,19379,697256,329716224
2020-04-30,19028290,322460222,2600,9279,344251,322804473
2020-05-06,64153960,348504347,4100,13379,545997,349050344
2020-05-07,168210770,390409199,14300,26179,1175175,391584374
2020-05-08,110816977,354039786,1500,19479,925253,354965039
2020-05-11,115496680,401239484,5200,20279,972986,402212470
2020-05-12,89096505,425374508,300,13679,655224,426029732
2020-05-13,64760144,430906627,5500,19179,922510,431829137
2020-05-14,62170557,415356780,5300,19979,945007,416301787
2020-05-15,94871641,421311592,7600,26079,1264832,422576424
2020-05-18,93927193,414924049,7500,19579,881838,415805887
2020-05-19,53811998,372577361,2500,20379,937434,373514795
2020-05-20,45294796,372132658,6100,23079,1031631,373164289
2020-05-21,43491089,372699673,4100,19879,883820,373583493
2020-05-22,34880985,375401272,3500,21679,949540,376350812
2020-05-25,33776068,383718060,2300,17679,782826,384500886
2020-05-26,62826295,383722594,8200,22779,1030066,384752660
2020-05-27,39626235,383059764,7200,19479,857076,383916840
2020-05-28,41777466,386940887,5200,15279,672734,387613621
2020-05-29,31824392,367383221,11100,20779,927367,368310588
2020-06-01,55506939,346134047,800,13279,631151,346765198
2020-06-02,35792968,340226420,8100,20879,989665,341216085
2020-06-03,49463813,353276455,4100,24479,1153450,354429905
2020-06-04,36700352,334000248,4904,27683,1324632,335324880
2020-06-05,70433876,333801419,5500,29483,1488302,335289721
2020-06-08,22567101,304138505,400,24083,1202946,305341451
2020-06-09,35633965,314987007,400,17583,885832,315872839
2020-06-10,51158467,310156963,3500,11879,609274,310766237
2020-06-11,32101176,313273397,8000,18779,933129,314206526
2020-06-12,14108694,300629988,5400,13779,676962,301306950
2020-06-15,26608793,305188075,13600,24579,1206092,306394167
2020-06-16,23634851,308272481,5800,27779,1379227,309651708
2020-06-17,23172817,311110626,3000,30079,1469660,312580286
2020-06-18,16380627,303380189,3500,32979,1619269,304999458
2020-06-19,54662201,320029784,2900,27279,1366405,321396189
2020-06-22,48482398,298165645,5600,25479,1391153,299556798
2020-06-23,104372124,314130389,4200,18379,920604,315050993
2020-06-24,52680510,307957091,7368,21347,1026577,308983668
2020-06-29,20038607,308943001,6500,25847,1250478,310193479
2020-06-30,29907153,306775367,1500,11647,570819,307346186
2020-07-01,47072620,314474285,13400,20747,1029674,315503959
2020-07-02,18067088,293837424,3300,13747,678140,294515564
2020-07-03,24268118,288711886,3500,8847,434830,289146716
2020-07-06,39626554,279725614,10100,14747,757111,280482725
2020-07-07,59267090,263247688,4100,8847,484816,263732504
2020-07-08,23909863,247354005,17400,25447,1415108,248769113
2020-07-09,53118735,264863810,0,11047,608137,265471947
2020-07-10,22132072,255627899,2200,11247,604976,256232875
2020-07-13,45947759,269307768,2700,9147,504914,269812682
2020-07-14,73918862,290015398,8000,15347,831807,290847205
2020-07-15,25673704,285756436,1500,9847,516968,286273404
2020-07-16,23907907,281781171,6200,12447,634797,282415968
2020-07-17,22144648,281002698,1325,6172,315698,281318396
2020-07-20,20320860,281779591,4000,8772,459302,282238893
2020-07-21,30534654,282210783,3000,11772,635688,282846471
2020-07-22,17692306,269702647,1300,12972,700488,270403135
2020-07-23,27280526,271432425,9400,15572,849453,272281878
2020-07-24,15902998,260022398,6700,12372,641859,260664257
2020-07-27,28993216,246984665,4900,14272,792381,247777046
2020-07-28,46227919,231823464,6800,19072,1091872,232915336
2020-07-29,30061830,239518440,800,15504,891635,240410075
2020-07-30,54985502,257676668,12100,21604,1263402,258940070
2020-07-31,30612818,248401546,1100,13504,794710,249196256
2020-08-03,32412858,251902370,3200,14804,886019,252788389
2020-08-04,40897770,258843143,12000,25304,1490406,260333549
2020-08-05,18502999,253240752,700,20404,1213018,254453770
2020-08-06,22632016,251257922,3700,20304,1164028,252421950
2020-08-07,14298809,241516113,4400,21404,1209540,242725653
2020-08-10,22005896,246418143,1800,10904,608988,247027131
2020-08-11,15921487,248766779,2300,11304,617538,249384317
2020-08-12,19586972,250852956,3600,12104,652769,251505725
2020-08-13,10529544,255373163,2000,12404,661877,256035040
2020-08-14,25761830,253648836,1700,12404,690655,254339491
2020-08-17,20733248,253437583,2400,12304,699359,254136942
2020-08-18,32251732,257380756,1700,9104,517471,257898227
2020-08-19,15249512,248693971,9100,17904,1009428,249703399
2020-08-20,26042443,260726119,600,14204,804088,261530207
2020-08-21,14919322,265967156,2800,14104,785170,266752326
2020-08-24,31635592,249817400,11100,25204,1484516,251301916
2020-08-25,22213138,244882839,300,21504,1268951,246151790
2020-08-26,40499712,266223844,3400,21804,1220588,267444432
2020-08-27,10711745,262068506,400,11504,636056,262704562
2020-08-28,10768507,251993007,1800,12904,734754,252727761
2020-08-31,17539265,257466112,2500,10804,603728,258069840
2020-09-01,17864011,247968919,1900,12104,692954,248661873
2020-09-02,17284504,252061211,6000,15704,890888,252952099
2020-09-03,9006754,248111312,2500,15204,862067,248973379
2020-09-04,13224942,247522133,2000,13504,746771,248268904
2020-09-07,13834456,241377671,900,11804,623841,242001512
2020-09-08,16108841,243455638,1700,10804,559539,244015177
2020-09-09,9479961,245596862,3600,13704,685063,246281925
2020-09-10,5889276,239908324,1400,8704,428498,240336822
2020-09-11,7777777,237551872,700,7204,364090,237915962
2020-09-14,8723280,238436708,5000,12004,606562,239043270
2020-09-15,4463810,239217892,2100,12604,639653,239857545
2020-09-16,7379294,239723087,400,12904,644168,240367255
2020-09-17,6867148,238695843,1500,12904,646232,239342075
2020-09-18,5607991,235639336,1500,12904,657975,236297311
2020-09-21,12653512,238729478,1600,13004,662034,239391512
2020-09-22,8319502,242469302,1500,12504,624575,243093877
2020-09-23,2595110,239397441,4400,16604,835679,240233120
2020-09-24,8401131,242061423,1600,10504,512700,242574123
2020-09-25,1722442,235699012,1200,11404,557656,236256668
2020-09-28,2588703,234118189,4100,14004,676113,234794302
2020-09-29,5753705,232908485,1000,14504,716353,233624838
2020-09-30,2349162,228622742,2800,16004,782596,229405338
2020-10-09,14441233,231458104,2300,13704,703289,232161393
2020-10-12,20200357,239542225,3000,13004,691423,240233648
2020-10-13,13206805,239231385,5000,15004,794162,240025547
2020-10-14,16649643,239790315,1900,14504,747246,240537561
2020-10-15,7452874,230506888,1100,13704,700274,231207162
2020-10-16,6982046,230359370,500,14204,727955,231087325
2020-10-19,5845930,233587277,600,11304,579556,234166833
2020-10-20,7938638,237403515,5800,14304,733509,238137024
2020-10-21,6948849,234289198,1300,13104,655200,234944398
2020-10-22,3860702,232023575,1400,12904,648684,232672259
2020-10-23,8919583,232739209,1700,13104,645896,233385105
2020-10-26,8915534,235156459,1000,11504,551387,235707846
2020-10-27,7363732,238231668,1700,12204,577737,238809405
2020-10-28,25856751,247754060,5200,16804,852131,248606191
2020-10-29,24715713,254841590,600,5104,262652,255104242
2020-10-30,20747702,256958324,6100,9404,460326,257418650
2020-11-02,12088402,257569377,3500,9104,455109,258024486
2020-11-03,20863438,262558224,4600,12204,609224,263167448
2020-11-04,20460850,261602165,5900,16604,833189,262435354
2020-11-05,72062149,277853826,0,13204,719618,278573444
2020-11-06,37830313,263258992,5100,17304,931301,264190293
2020-11-09,66937426,286961444,300,14304,793300,287754744
2020-11-10,32202538,292376961,4200,16204,884576,293261537
2020-11-11,33800796,301223182,2200,15966,853862,302077044
2020-11-12,37133606,293304542,2200,15966,885315,294189857
2020-11-13,41372135,295246298,2400,17366,972496,296218794
2020-11-16,50388238,320414625,1000,12466,683386,321098011
2020-11-17,31425513,325293489,3100,15366,830840,326124329
2020-11-18,17594309,316285618,1100,13366,716017,317001635
2020-11-19,25777355,324448995,1600,13966,753186,325202181
2020-11-20,33571063,334019475,4100,16466,881425,334900900
2020-11-23,43568459,330210521,2100,13466,737937,330948458
2020-11-24,31961508,333104894,4000,15366,830840,333935734
2020-11-25,33572078,328489504,100,14366,772029,329261533
2020-11-26,63194507,334737614,2000,11766,594183,335331797
2020-11-27,14521129,330652846,1800,11566,578416,331231262
2020-11-30,20687143,317711071,5400,8666,448639,318159710
2020-12-01,20197932,320570865,1500,5766,299890,320870755
2020-12-02,12229782,312851101,11000,14766,766060,313617161
2020-12-03,8794371,310415051,500,14866,771248,311186299
2020-12-04,8574082,307944168,2000,16866,875345,308819513
2020-12-07,12581753,307624865,100,13866,723112,308347977
2020-12-08,13876488,307233704,4000,17766,936091,308169795
2020-12-09,30450646,318870603,100,15066,791116,319661719
2020-12-10,17196083,310595639,700,11066,586498,311182137
2020-12-11,17634767,310806772,2300,12466,634519,311441291
2020-12-14,9668490,309531735,4300,16066,821776,310353511
2020-12-15,23587838,308195147,2500,14366,758668,308953815
2020-12-16,12170552,299491705,3400,15466,816605,300308310
2020-12-17,21790128,306503652,200,11866,622016,307125668
2020-12-18,17933972,305699594,4100,13366,692359,306391953
2020-12-21,57786518,325478476,1200,12166,659762,326138238
2020-12-22,48602600,330055905,4100,15666,823405,330879310
2020-12-23,44430397,343266240,400,16066,928936,344195176
2020-12-24,188436373,413347566,1000,15166,964558,414312124
2020-12-25,153194541,358626962,1900,15566,1011790,359638752
2020-12-28,144942267,415263499,3000,18566,1266387,416529886
2020-12-29,112368083,459502687,0,15666,1021737,460524424
2020-12-30,102923187,468555668,0,12666,848875,469404543
2020-12-31,76956180,461790860,4400,9266,626382,462417242
2021-01-04,102318237,485479398,9300,17466,1248644,486728042
2021-01-05,75575971,478772526,600,16066,1117230,479889756
2021-01-06,86345845,512342884,300,14866,1028133,513371017
2021-01-07,65898313,509890171,600,11466,768910,510659081
2021-01-08,41046376,448050999,4000,15166,1017639,449068638
2021-01-11,45146636,422689813,3000,18166,1239285,423929098
2021-01-12,30547008,416596033,300,12466,850431,417446464
2021-01-13,43220160,408015789,300,10166,697388,408713177
2021-01-14,111770759,426947559,4500,13266,947325,427894884
2021-01-15,46763327,405523857,5200,10666,750246,406274103
2021-01-18,43489591,385336795,900,8866,644026,385980821
2021-01-19,61970806,384407978,9200,16266,1137481,385545459
2021-01-20,74567442,397547306,1600,16366,1191281,398738587
2021-01-21,80886107,427820014,300,15766,1131211,428951225
2021-01-22,149237473,455282019,2700,16766,1323340,456605359
2021-01-25,156526478,495838018,1700,16866,1323644,497161662
2021-01-26,89515412,501342714,300,13666,1013334,502356048
2021-01-27,52897105,483709672,1500,13666,976162,484685834
2021-01-28,44621534,483998765,2000,13366,909022,484907787
2021-01-29,28097181,470001714,2300,13866,941501,470943215
2021-02-01,39817423,447641912,2000,13166,972836,448614748
2021-02-02,50359336,426269340,5200,16466,1251416,427520756
2021-02-03,32807952,421422120,500,16966,1280594,422702714
2021-02-04,39492667,408526335,1300,14566,1071912,409598247
2021-02-05,30767361,411799861,1300,13666,988872,412788733
2021-02-08,21595108,399574108,1700,14066,1030053,400604161
2021-02-09,35649901,404162951,1500,15366,1152450,405315401
2021-02-10,39080056,399440858,1300,12266,938349,400379207
2021-02-18,58143637,409452470,6200,15266,1171666,410624136
2021-02-19,50297827,427352125,1200,12266,920686,428272811
2021-02-22,54462565,424368099,4100,12866,909112,425277211
2021-02-23,20375604,415987558,0,6366,446320,416433878
2021-02-24,30033452,417596263,2500,7666,521365,418117628
2021-02-25,18021335,413445088,3000,10566,711937,414157025
2021-02-26,15930666,406775616,300,4566,308433,407084049
2021-03-01,37911422,415022301,4100,8666,621352,415643653
2021-03-02,21282915,402620389,9800,15366,1122025,403742414
2021-03-03,19630859,396191625,3000,16966,1266851,397458476
2021-03-04,25824278,402378487,1400,13266,973990,403352477
2021-03-05,8880406,398926116,2100,8466,618357,399544473
2021-03-08,26307925,403431956,6000,13566,994930,404426886
2021-03-09,13150850,395715149,4900,15366,1073622,396788771
2021-03-10,9700310,393762233,2500,17166,1200590,394962823
2021-03-11,18408474,401754082,700,10966,778147,402532229
2021-03-12,12924869,403067609,7500,18266,1280447,404348056
2021-03-15,19335697,405224193,100,13566,945686,406169879
2021-03-16,13582393,401738677,3100,14766,1012800,402751477
2021-03-17,6956526,393700890,3600,17866,1233826,394934716
2021-03-18,16911821,396130657,100,17966,1271993,397402650
2021-03-19,14206981,392546081,400,15366,1093291,393639372
2021-03-22,38057236,409137798,2700,9266,690688,409828486
2021-03-23,35854416,402007052,9000,15666,1173383,403180435
2021-03-24,19727600,396702604,2800,13166,959801,397662405
2021-03-25,35406219,412391482,200,10566,786110,413177592
2021-03-26,25405285,415410959,2800,13066,974724,416385683
2021-03-29,60655281,404349455,200,10466,717130,405066585
2021-03-30,30039788,404843660,4200,14366,995420,405839080
2021-03-31,11758649,407221044,2500,14066,960567,408181611
2021-04-01,18824153,416714039,700,13866,948573,417662612
2021-04-02,24126020,415983725,2700,15566,1074832,417058557
2021-04-06,10648129,415137759,700,13666,956347,416094106
2021-04-07,10114218,410590004,2600,16066,1112571,411702575
2021-04-08,10821180,411474952,800,14666,1014741,412489693
2021-04-09,49703482,430569762,2200,16066,1128476,431698238
2021-04-12,23695240,431418088,200,16066,1076422,432494510
2021-04-13,22593793,428291985,900,14866,1008658,429300643
2021-04-14,15664781,431153100,8900,21466,1469348,432622448
2021-04-15,11974848,434412517,1800,21466,1459903,435872420
2021-04-16,16298504,435649163,2100,22266,1514088,437163251
2021-04-19,32848869,453077120,1200,23466,1626428,454703548
2021-04-20,18542157,456780483,500,20366,1406272,458186755
2021-04-21,17450504,455830774,100,19666,1362657,457193431
2021-04-22,35371376,456724037,600,20166,1429769,458153806
2021-04-23,25988406,440169432,5600,23166,1647798,441817230
2021-04-26,51602022,456269347,3100,25566,1828992,458098339
2021-04-27,31835552,453598704,100,25566,1852768,455451472
2021-04-28,43580925,469224986,800,23866,1718352,470943338
2021-04-29,31680180,453258767,2300,24866,1743107,455001874
2021-04-30,27714977,441587606,700,22966,1640691,443228297
2021-05-06,49310642,432537678,2900,21066,1537607,434075285
2021-05-07,31873263,427394219,4700,16366,1148075,428542294
2021-05-10,20964982,424001758,1100,13566,956267,424958025
2021-05-11,16804647,405254161,9980,27131,1263490,406517651
2021-05-12,31929594,406834737,9600,25216,1142789,407977526
2021-05-13,41629183,388340776,13900,27416,1155585,389496361
2021-05-14,26426428,386622388,9700,25921,1125230,387747618
2021-05-17,32055823,395733268,12100,24121,1050711,396783979
2021-05-18,13465144,391216099,7900,20921,902950,392119049
2021-05-19,30945754,387075224,15500,27421,1198298,388273522
2021-05-20,16066372,371069308,9922,22143,954584,372023892
2021-05-21,16676420,365019980,2700,16021,672081,365692061
2021-05-24,13298230,360101331,3200,16021,670960,360772291
2021-05-25,17586706,361101565,10100,25721,1087226,362188791
2021-05-26,12923834,359281097,20400,30821,1309276,360590373
2021-05-27,25465888,368545694,12100,26021,1107975,369653669
2021-05-28,36537640,374618789,18600,32521,1401655,376020444
2021-05-31,37498902,379571254,12800,30921,1365471,380936725
2021-06-01,21066200,378549097,12800,33721,1481364,380030461
2021-06-02,18948863,373253614,9200,30121,1296107,374549721
2021-06-03,13172185,369567876,11100,26321,1111799,370679675
2021-06-04,148323905,412044956,14000,18721,854052,412899008
2021-06-07,98619052,457726075,20400,24621,1095388,458821463
2021-06-08,46577047,453998156,16400,24621,1100067,455098223
2021-06-09,42672847,464867427,9500,22121,986597,465854024
2021-06-10,30988964,420582955,11200,16121,713676,421296631
2021-06-11,32667611,399279069,12900,22521,1006239,400285308
2021-06-15,43779314,408104805,11400,18921,857689,408962494
2021-06-16,36448405,395712163,7400,18506,796683,396508846
2021-06-17,28499258,398487252,3100,16506,714049,399201301
2021-06-18,23338351,393529001,19600,30506,1314198,394843199
2021-06-21,34049777,400366904,0,17706,751973,401118877
2021-06-22,17474759,400872632,6700,23406,1000607,401873239
2021-06-23,74283596,407262443,4300,20006,901670,408164113
2021-06-24,65270070,419637403,7300,23306,1079534,420716937
2021-06-25,41036516,422507264,3100,19406,887243,423394507
2021-06-28,41732972,431029542,3500,20006,915475,431945017
2021-06-29,48849953,436882722,9400,18506,841467,437724189
2021-06-30,39661316,433338695,8800,12206,560256,433898951
2021-07-01,24024404,426025080,16274,21280,950152,426975232
2021-07-02,24209821,426702301,19500,30780,1337390,428039691
2021-07-05,101749655,465831271,14600,38206,1786131,467617402
2021-07-06,30326373,431734412,11400,40606,1859755,433594167
2021-07-07,117622378,476419440,9100,38106,1828707,478248147
2021-07-08,94407568,499416119,10900,41606,2013730,501429849
2021-07-09,166111237,570507661,9300,23006,1176757,571684418
2021-07-12,122454047,545076907,19600,26706,1374824,546451731
2021-07-13,141118718,568462172,9700,25001,1324553,569786725
2021-07-14,172257761,584052026,12495,28596,1363458,585415484
2021-07-15,71555613,568955232,11350,19486,914673,569869905
2021-07-16,62272210,547934450,10885,19271,892825,548827275
2021-07-19,45426822,538963792,10055,19771,899976,539863768
2021-07-20,29244096,540078407,7175,20446,937654,541016061
2021-07-21,67716655,547433510,8355,20426,947766,548381276
2021-07-22,69284819,528590001,10900,16471,744654,529334655
2021-07-23,68681914,528805942,24100,28771,1244346,530050288
2021-07-26,43433094,511440630,2300,14916,617075,512057705
2021-07-27,31295819,502149844,19614,25630,1049804,503199648
2021-07-28,32801958,491454674,6100,14330,558870,492013544
2021-07-29,31788093,482367799,7400,16330,655649,483023448
2021-07-30,35950101,470968686,50339,58669,2430070,473398756
2021-08-02,56323109,487284339,8900,54869,2329737,489614076
2021-08-03,24544569,482745212,13700,60769,2502468,485247680
2021-08-04,36349022,491640425,5900,60369,2531272,494171697
2021-08-05,25026876,466891445,20800,67269,2741884,469633329
2021-08-06,28772584,464026807,56800,98971,4086513,468113320
2021-08-09,22994571,459327198,51600,108371,4429123,463756321
2021-08-10,30367584,466061105,35899,112168,4597766,470658871
2021-08-11,57348380,476298755,47200,106869,4520559,480819314
2021-08-12,31867792,470189187,49400,117969,4962956,475152143
2021-08-13,42006540,474952451,46555,121394,5032995,479985446
2021-08-16,23547682,477605741,21700,93139,3778649,481384390
2021-08-17,22750453,478972960,36507,94631,3731301,482704261
2021-08-18,9701196,472795027,3300,41539,1658652,474453679
2021-08-19,17458740,471095803,5500,40089,1612781,472708584
2021-08-20,18372209,462429118,4200,36889,1451951,463881069
2021-08-23,21641926,463980733,600,27455,1093532,465074265
2021-08-24,41818442,475951899,4900,32155,1259512,477211411
2021-08-25,35855511,482013928,77686,107841,4129232,486143160
2021-08-26,31692590,483663397,15900,110641,4158995,487822392
2021-08-27,28428239,489436666,13200,108341,4030285,493466951
2021-08-30,33050258,484872947,25600,120856,4644496,489517443
2021-08-31,23380092,478500521,17300,121421,4592142,483092663
2021-09-01,31441813,468613567,12100,122021,4423261,473036828
2021-09-02,11266873,459465312,10100,117321,4277524,463742836
2021-09-03,21002473,452213545,8575,114096,4068664,456282209
2021-09-06,21144706,446314311,5300,32470,1176388,447490699
2021-09-07,19351485,441224502,12400,42670,1548494,442772996
2021-09-08,41636768,452056196,8800,42270,1583434,453639630
2021-09-09,25541566,450711319,38900,69870,2580998,453292317
2021-09-10,35896585,461631627,8700,68870,2539925,464171552
2021-09-13,40737945,478236799,24200,80270,2888918,481125717
2021-09-14,26286940,479904620,26100,71370,2589304,482493924
2021-09-15,28467461,477978744,38900,69370,2467491,480446235
2021-09-16,19857899,466025601,25372,60242,2054854,468080455
2021-09-17,19230294,462187716,46795,73665,2455991,464643707
2021-09-22,7259558,458309077,46700,73665,2450098,460759175
2021-09-23,7662519,455505335,52150,78935,2657742,458163077
2021-09-24,6107083,448544540,25000,75035,2497915,451042455
2021-09-27,19518469,426382261,50335,94098,3168280,429550541
2021-09-28,16587225,426088634,56900,101798,3369514,429458148
2021-09-29,29067260,436400573,51600,113608,3546842,439947415
2021-09-30,3476301,414909836,46500,90643,2915079,417824915
2021-10-08,11188376,419252803,51100,95243,3089683,422342486
2021-10-11,7902510,418250124,50300,96043,3142527,421392651
2021-10-12,12082623,421730425,67400,113308,3623590,425354015
2021-10-13,13624944,421635921,45400,106708,3488285,425124206
2021-10-14,18489987,425420957,46655,102163,3384661,428805618
2021-10-15,16347175,423457233,53700,109163,3650411,427107644
2021-10-18,13574811,422141220,46300,89163,2994094,425135314
2021-10-19,51102557,440557610,59700,102663,3639404,444197014
2021-10-20,37020143,448936321,42200,80334,2875957,451812278
2021-10-21,141781575,510481975,26900,63934,2517721,512999696
2021-10-22,188688870,540904650,27000,59934,2314651,543219301
2021-10-25,190461051,646119929,28500,61434,2609717,648729646
2021-10-26,389086868,702124291,44000,78534,3541884,705666175
2021-10-27,186281282,612343280,26800,70634,3090238,615433518
2021-10-28,137487299,598076684,37800,80934,3294823,601371507
2021-10-29,131798193,600615103,28560,69894,2952323,603567426
2021-11-01,259520429,727853334,28700,71094,3234066,731087400
2021-11-02,147694288,747975697,41755,84749,3675564,751651261
2021-11-03,68146019,736678737,27000,51349,2177711,738856448
2021-11-04,96648437,748395673,61692,86241,3566928,751962601
2021-11-05,96841614,753724990,45100,68941,2747988,756472978
2021-11-08,107088643,796125444,75059,98100,3958335,800083779
2021-11-09,77856050,666381933,50600,94400,3708976,670090909
2021-11-10,72991295,647654827,18100,35280,1349813,649004640
2021-11-11,53952807,632322995,19000,30080,1145747,633468742
2021-11-12,198270294,681481253,39000,49580,2077402,683558655
2021-11-15,246037638,768841546,37000,65080,2840091,771681637
2021-11-16,66148872,727008325,28655,65635,2780299,729788624
2021-11-17,132955720,766255603,3200,50635,2196546,768452149
2021-11-18,203978213,834224219,50100,89335,4036155,838260374
2021-11-19,194067273,798389289,31600,73880,3277317,801666606
2021-11-22,311844742,917473078,59900,78980,3854224,921327302
2021-11-23,203166043,972949134,45100,88380,4228983,977178117
2021-11-24,143743191,970266486,27800,52580,2415525,972682011
2021-11-25,80881216,962515734,46300,71080,3292426,965808160
2021-11-26,151649268,971325609,43400,85180,4084381,975409990
2021-11-29,185624776,993369543,55900,103980,5199000,998568543
2021-11-30,140253830,1017745816,21300,96880,4764558,1022510374
2021-12-01,116632316,1041792043,0,60380,2884956,1044676999
2021-12-02,100912920,1012424222,23165,77945,3721874,1016146096
2021-12-03,101184340,1014662605,15765,80245,3775527,1018438132
2021-12-06,133725653,984432903,12800,65080,3127094,987559997
2021-12-07,139310488,1004563632,25700,79980,3554311,1008117943
2021-12-08,86951602,958114554,19683,84063,4024936,962139490
2021-12-09,104208779,978302180,11200,74080,3628438,981930618
2021-12-10,62562470,981967975,8600,73780,3601940,985569915
2021-12-13,71926151,919377231,25222,85802,4118496,923495727
2021-12-14,63113031,933999575,8300,84802,3932269,937931844
2021-12-15,46664864,901383889,12500,76202,3577684,904961573
2021-12-16,262022631,842085674,31200,77802,4018473,846104147
2021-12-17,230594941,968653845,8800,85602,4863906,973517751
2021-12-20,260034114,1005985808,11500,74902,4037218,1010023026
2021-12-21,138999161,1002002897,19600,80302,4353975,1006356872
2021-12-22,394112978,992374120,28700,91502,5457179,997831299
2021-12-23,240324358,899227602,29300,70980,4453995,903681597
2021-12-24,150169438,779139337,8100,74880,4680000,783819337
2021-12-27,93767002,771918817,19500,68080,4152880,776071697
2021-12-28,128716439,784804250,19500,58780,3572648,788376898
2021-12-29,109114935,809110212,22300,61480,3611335,812721547
2021-12-30,71078141,820119127,19600,57880,3365722,823484849
2021-12-31,47611201,803860479,100,33080,1929226,805789705
2022-01-04,65007128,792957672,21800,47280,2686922,795644594
