日期,融资买入额(元),融资余额(元),融券卖出量,融券余量,融券余额(元),融资融券余额(元)
2017-07-12,4082777,117896396,0,0,0,117896396
2017-07-13,2162891,117646961,0,0,0,117646961
2017-07-14,721684,115599859,0,0,0,115599859
2017-07-17,5885181,114763476,50000,50000,222000,114985476
2017-07-18,2591713,115583848,0,50000,223000,115806848
2017-07-19,5898064,117187490,0,0,0,117187490
2017-07-20,14699955,123580262,170000,170000,783700,124363962
2017-07-21,5297985,121411880,0,70024,320710,121732590
2017-07-24,7841598,123309286,0,70024,324211,123633497
2017-07-25,3288406,119995460,0,70024,320710,120316170
2017-07-26,1813844,120156665,0,30024,136609,120293274
2017-07-27,7315152,112806144,0,30024,140813,112946957
2017-07-28,5125821,112087761,109900,139900,656131,112743892
2017-07-31,6107487,114689143,0,90000,422100,115111243
2017-08-01,6014532,113914458,0,90000,421200,114335658
2017-08-02,17715957,121664558,85400,175400,861214,122525772
2017-08-03,14009860,120850953,0,90000,439200,121290153
2017-08-04,10457323,116873208,0,90000,439200,117312408
2017-08-07,6313654,114789238,50000,110000,532400,115321638
2017-08-08,6501547,115676753,0,110000,529100,116205853
2017-08-09,6389193,115409327,0,110000,525800,115935127
2017-08-10,6227271,116351909,0,50000,235000,116586909
2017-08-11,4082705,115822172,0,50000,231000,116053172
2017-08-14,1330429,115360119,0,0,0,115360119
2017-08-15,1128258,113045698,0,0,0,113045698
2017-08-16,2323520,113352979,0,0,0,113352979
2017-08-17,3694857,112618283,0,0,0,112618283
2017-08-18,5178827,112603836,30000,30000,144300,112748136
2017-08-21,4915482,112803362,0,0,0,112803362
2017-08-22,5525714,113699608,80000,80000,383200,114082808
2017-08-23,14473912,116559191,0,80000,388800,116947991
2017-08-24,10660355,119684111,0,30000,143400,119827511
2017-08-25,9911481,122131323,0,30000,146100,122277423
2017-08-28,11133544,123905523,0,30000,149400,124054923
2017-08-29,23449773,123878777,0,30000,164400,124043177
2017-08-30,56790101,133214977,0,30000,159900,133374877
2017-08-31,56628865,147621038,100000,130000,726700,148347738
2017-09-01,47110613,139895430,50000,130000,705900,140601330
2017-09-04,36177536,141163829,0,130000,669500,141833329
2017-09-05,17658076,144554984,0,130000,660400,145215384
2017-09-06,12620851,144381204,0,130000,655200,145036404
2017-09-07,15139328,144353484,0,130000,647400,145000884
2017-09-08,9893951,144321826,0,80000,397600,144719426
2017-09-11,8727346,145313751,0,80000,397600,145711351
2017-09-12,12403691,146247613,0,80000,392000,146639613
2017-09-13,10784774,145552953,0,80000,396000,145948953
2017-09-14,6765906,146152011,0,80000,390400,146542411
2017-09-15,5866121,147816849,0,80000,390400,148207249
2017-09-18,8088366,151271708,0,80000,390400,151662108
2017-09-19,4943837,151724899,0,80000,388000,152112899
2017-09-20,6063177,154819473,0,80000,388000,155207473
2017-09-21,7230935,153793395,0,80000,388800,154182195
2017-09-22,4126804,149653773,0,80000,385600,150039373
2017-09-25,7198242,149582542,0,80000,373600,149956142
2017-09-26,4540951,150087679,0,80000,374400,150462079
2017-09-27,3536191,148499815,0,80000,372800,148872615
2017-09-28,4100511,147976006,0,80000,368800,148344806
2017-09-29,923026,139950691,0,80000,370400,140321091
2017-10-09,6916212,142156318,0,80000,374400,142530718
2017-10-10,4342146,140997107,0,80000,376000,141373107
2017-10-11,5623208,141284026,0,80000,378400,141662426
2017-10-12,3352613,139980954,0,80000,377600,140358554
2017-10-13,7457226,144710258,0,80000,377600,145087858
2017-10-16,5989182,142651856,0,80000,370400,143022256
2017-10-17,2139623,141321606,0,80000,368800,141690406
2017-10-18,4452810,142401556,0,80000,367200,142768756
2017-10-19,5102129,138435585,0,80000,357600,138793185
2017-10-20,1737272,137375034,0,80000,364000,137739034
2017-10-23,1949079,135638892,0,80000,365600,136004492
2017-10-24,2693386,135748772,0,80000,363200,136111972
2017-10-25,3955498,136879679,0,80000,366400,137246079
2017-10-26,11200899,144439554,0,80000,367200,144806754
2017-10-27,2559322,143878430,0,80000,364800,144243230
2017-10-30,6868019,141513515,0,80000,356000,141869515
2017-10-31,3793987,137901968,0,80000,356800,138258768
2017-11-01,1138292,134936820,0,80000,360000,135296820
2017-11-02,3636572,135303979,0,80000,363200,135667179
2017-11-03,1352340,133487972,0,80000,360000,133847972
2017-11-06,1646192,132915436,0,80000,368000,133283436
2017-11-07,1836077,130891334,0,80000,368800,131260134
2017-11-08,1688008,127018037,0,80000,368000,127386037
2017-11-09,1577369,125400015,0,80000,368800,125768815
2017-11-10,1526997,123613489,0,80000,369600,123983089
2017-11-13,1761263,123114235,0,80000,365600,123479835
2017-11-14,6219751,127699944,0,80000,362400,128062344
2017-11-15,3718983,129222411,0,80000,357600,129580011
2017-11-16,2893094,129821768,0,80000,357600,130179368
2017-11-17,6707549,133217517,0,80000,349600,133567117
2017-11-20,4111017,131294994,0,80000,340800,131635794
2017-11-21,1276881,131283311,0,80000,339200,131622511
2017-11-22,323629,130303080,0,80000,336800,130639880
2017-11-23,2604863,130670012,0,80000,328800,130998812
2017-11-24,4677066,133694254,0,80000,328800,134023054
2017-11-27,2209619,131323122,0,80000,323200,131646322
2017-11-28,1302241,131648566,0,80000,325600,131974166
2017-11-29,1933990,130761963,0,80000,328800,131090763
2017-11-30,678139,130473948,0,80000,327200,130801148
2017-12-01,1316402,125919052,0,80000,328000,126247052
2017-12-04,1571378,125856848,0,80000,322400,126179248
2017-12-05,2606093,125205406,0,80000,314400,125519806
2017-12-06,2415409,125324170,0,80000,315200,125639370
2017-12-07,713909,124039308,0,80000,312800,124352108
2017-12-08,392642,123363934,0,80000,316000,123679934
2017-12-11,1201043,122718224,0,80000,320000,123038224
2017-12-12,1811651,122920601,0,80000,315200,123235801
2017-12-13,1033127,123166901,0,80000,316800,123483701
2017-12-14,1409281,123606863,0,80000,315200,123922063
2017-12-15,1741064,123904757,0,80000,315200,124219957
2017-12-18,2578276,124491625,0,30000,119100,124610725
2017-12-19,1423662,124390115,0,30000,119100,124509215
2017-12-20,1801790,124736446,0,30000,117000,124853446
2017-12-21,1926106,125332785,0,30000,115800,125448585
2017-12-22,2445836,126014786,0,30000,116700,126131486
2017-12-25,1260920,125554764,0,30000,114300,125669064
2017-12-26,2539096,125982412,0,30000,114600,126097012
2017-12-27,1643788,125470973,0,30000,114900,125585873
2017-12-28,2192988,126159312,0,30000,115200,126274512
2017-12-29,1173817,124771172,0,30000,115800,124886972
2018-01-02,2137555,124908201,0,0,0,124908201
2018-01-03,7932104,128695779,0,0,0,128695779
2018-01-04,6163538,129371393,0,0,0,129371393
2018-01-05,6373249,127034823,0,0,0,127034823
2018-01-08,4026695,122275934,0,0,0,122275934
2018-01-09,2213150,122030304,0,0,0,122030304
2018-01-10,4603770,123319253,0,0,0,123319253
2018-01-11,3710795,124484058,0,0,0,124484058
2018-01-12,1861457,124086433,0,0,0,124086433
2018-01-15,6909802,123983147,0,0,0,123983147
2018-01-16,2241494,124724247,0,0,0,124724247
2018-01-17,1956113,124943605,0,0,0,124943605
2018-01-18,2539839,125809028,0,0,0,125809028
2018-01-19,2090096,125144459,0,0,0,125144459
2018-01-22,3911335,124138149,0,0,0,124138149
2018-01-23,8191432,129703847,0,0,0,129703847
2018-01-24,3396554,129825665,0,0,0,129825665
2018-01-25,7549720,133340776,0,0,0,133340776
2018-01-26,2350460,133247678,0,0,0,133247678
2018-01-29,11821263,138597409,0,0,0,138597409
2018-01-30,3541313,139984343,0,0,0,139984343
2018-01-31,5920810,140017859,0,0,0,140017859
2018-02-01,6337247,136871554,0,0,0,136871554
2018-02-02,3038499,134869446,0,0,0,134869446
2018-02-05,2254440,133606980,0,0,0,133606980
2018-02-06,6604978,133193322,0,0,0,133193322
2018-02-07,2894213,131289023,0,0,0,131289023
2018-02-08,2043719,129933033,0,0,0,129933033
2018-02-09,3587766,128690355,0,0,0,128690355
2018-02-12,5331475,128252199,0,0,0,128252199
2018-02-13,1789762,125788575,0,0,0,125788575
2018-02-14,1810394,123369880,0,0,0,123369880
2018-02-22,888550,119677121,0,0,0,119677121
2018-02-23,791218,119058155,0,0,0,119058155
2018-02-26,1886399,117586863,0,0,0,117586863
2018-02-27,1473138,118143401,0,0,0,118143401
2018-02-28,809238,117297867,0,0,0,117297867
2018-03-01,2638043,115843974,0,0,0,115843974
2018-03-02,5678122,113964331,0,0,0,113964331
2018-03-05,6656801,113724405,0,0,0,113724405
2018-03-06,2666234,112529319,0,0,0,112529319
2018-03-07,8457823,115811309,0,0,0,115811309
2018-03-08,8556992,118031392,0,0,0,118031392
2018-03-09,5093642,115389147,0,0,0,115389147
2018-03-12,2947114,115292167,0,0,0,115292167
2018-03-13,4922636,116381878,0,0,0,116381878
2018-03-14,2557383,115551328,0,0,0,115551328
2018-03-15,7456030,118021610,0,0,0,118021610
2018-03-16,3820614,116442255,0,0,0,116442255
2018-03-19,2447550,115978274,0,0,0,115978274
2018-03-20,4033381,115060300,0,0,0,115060300
2018-03-21,6745498,115624543,0,0,0,115624543
2018-03-22,18127578,118007317,0,0,0,118007317
2018-03-23,18563321,116680159,0,0,0,116680159
2018-03-26,16930440,123809550,0,0,0,123809550
2018-03-27,8329062,120322321,0,0,0,120322321
2018-03-28,5889032,119403746,0,0,0,119403746
2018-03-29,7574833,117728379,72300,72300,258111,117986490
2018-03-30,9352071,120138669,0,72300,257388,120396057
2018-04-02,7782807,118187339,0,72300,258111,118445450
2018-04-03,14299336,125496726,0,72300,253050,125749776
2018-04-04,12246880,134261437,0,72300,247989,134509426
2018-04-09,7047093,133818076,0,0,0,133818076
2018-04-10,6245928,135254307,0,0,0,135254307
2018-04-11,5815160,137447615,0,0,0,137447615
2018-04-12,9019407,136603271,0,0,0,136603271
2018-04-13,3991538,135715584,0,0,0,135715584
2018-04-16,4463988,137391741,0,0,0,137391741
2018-04-17,1008018,137268102,0,0,0,137268102
2018-04-18,972637,137209894,0,0,0,137209894
2018-04-19,673214,136548481,0,0,0,136548481
2018-04-20,841057,135080072,0,0,0,135080072
2018-04-23,1265330,135891905,0,0,0,135891905
2018-04-24,1291261,136135194,0,0,0,136135194
2018-04-25,1148986,136965229,0,0,0,136965229
2018-04-26,766941,136258457,0,0,0,136258457
2018-04-27,1523348,136521225,0,0,0,136521225
2018-05-02,1710066,137097824,0,0,0,137097824
2018-05-03,1303321,135513810,0,0,0,135513810
2018-05-04,5741248,138887140,0,0,0,138887140
2018-05-07,1215674,135975159,0,0,0,135975159
2018-05-08,1457887,132145914,0,0,0,132145914
2018-05-09,2226826,132017433,0,0,0,132017433
2018-05-10,2292580,132854477,0,0,0,132854477
2018-05-11,800634,129101045,0,0,0,129101045
2018-05-14,811359,128492407,0,0,0,128492407
2018-05-15,1099433,128206859,0,0,0,128206859
2018-05-16,4136535,131334775,0,0,0,131334775
2018-05-17,2143673,132445938,0,0,0,132445938
2018-05-18,4526241,133359307,0,0,0,133359307
2018-05-21,2132082,131525708,0,0,0,131525708
2018-05-22,1995800,131999455,0,0,0,131999455
2018-05-23,7532403,132762272,0,0,0,132762272
2018-05-24,5892485,133868452,0,0,0,133868452
2018-05-25,3228788,133257274,0,0,0,133257274
2018-05-28,4665188,134358078,0,0,0,134358078
2018-05-29,3543216,135565256,0,0,0,135565256
2018-05-30,1061854,133918762,0,0,0,133918762
2018-05-31,1410091,133555334,0,0,0,133555334
2018-06-01,850348,132456139,0,0,0,132456139
2018-06-04,2221753,133084277,0,0,0,133084277
2018-06-05,1182782,133362807,0,0,0,133362807
2018-06-06,407883,132439064,0,0,0,132439064
2018-06-07,2335577,131727348,0,0,0,131727348
2018-06-08,1800943,131893665,0,0,0,131893665
2018-06-11,614678,131694492,0,0,0,131694492
2018-06-12,446532,131632814,0,0,0,131632814
2018-06-13,1187914,131608890,0,0,0,131608890
2018-06-14,629756,131427964,0,0,0,131427964
2018-06-15,1228542,132225785,0,0,0,132225785
2018-06-19,1978173,130159713,0,0,0,130159713
2018-06-20,315428,129062406,0,0,0,129062406
2018-06-21,969836,128720267,0,0,0,128720267
2018-06-22,525198,127222990,0,0,0,127222990
2018-06-25,1037488,127464895,0,0,0,127464895
2018-06-26,997351,127599364,0,0,0,127599364
2018-06-27,476976,126908285,0,0,0,126908285
2018-06-28,325027,126955936,0,0,0,126955936
2018-06-29,619336,127070363,0,0,0,127070363
2018-07-02,670398,125726095,0,0,0,125726095
2018-07-03,2689295,127169149,0,0,0,127169149
2018-07-04,1944766,127820630,0,0,0,127820630
2018-07-05,552633,126183302,0,0,0,126183302
2018-07-06,547917,125433191,0,0,0,125433191
2018-07-09,1327346,125219327,0,0,0,125219327
2018-07-10,1606852,125527152,0,0,0,125527152
2018-07-11,411571,123960816,0,0,0,123960816
2018-07-12,1673612,124161822,0,0,0,124161822
2018-07-13,581348,123740806,0,0,0,123740806
2018-07-16,704915,123905210,0,0,0,123905210
2018-07-17,933386,124136217,0,0,0,124136217
2018-07-18,6638434,128441762,0,0,0,128441762
2018-07-19,1313533,128072985,0,0,0,128072985
2018-07-20,2439457,126919910,0,0,0,126919910
2018-07-23,1723901,125218810,0,0,0,125218810
2018-07-24,2849927,125218412,0,0,0,125218412
2018-07-25,1641324,125478413,0,0,0,125478413
2018-07-26,4875014,125116191,0,0,0,125116191
2018-07-27,4257911,126243808,0,0,0,126243808
2018-07-30,3930059,127239831,0,0,0,127239831
2018-07-31,7410540,124155344,0,0,0,124155344
2018-08-01,5061165,124643207,0,0,0,124643207
2018-08-02,3186731,124451269,0,0,0,124451269
2018-08-03,673373,123103180,0,0,0,123103180
2018-08-06,825963,123032390,0,0,0,123032390
2018-08-07,2197480,124150909,0,0,0,124150909
2018-08-08,857582,123098498,0,0,0,123098498
2018-08-09,2277654,123078893,0,0,0,123078893
2018-08-10,434457,121649123,0,0,0,121649123
2018-08-13,1215132,121485781,0,0,0,121485781
2018-08-14,433139,120789340,0,0,0,120789340
2018-08-15,647281,120836689,0,0,0,120836689
2018-08-16,472501,120750398,0,0,0,120750398
2018-08-17,1264031,120753104,0,0,0,120753104
2018-08-20,856933,120733540,0,0,0,120733540
2018-08-21,539626,120441387,0,0,0,120441387
2018-08-22,198439,120184754,0,0,0,120184754
2018-08-23,280880,119996698,0,0,0,119996698
2018-08-24,685442,119691337,0,0,0,119691337
2018-08-27,896823,118903456,0,0,0,118903456
2018-08-28,116928,118457853,0,0,0,118457853
2018-08-29,357050,118436131,0,0,0,118436131
2018-08-30,692665,118142607,0,0,0,118142607
2018-08-31,1361491,118384981,0,0,0,118384981
2018-09-03,312790,116540318,0,0,0,116540318
2018-09-04,2358322,117205765,0,0,0,117205765
2018-09-05,1213029,117917230,0,0,0,117917230
2018-09-06,1159904,118620660,0,0,0,118620660
2018-09-07,814616,118326106,0,0,0,118326106
2018-09-10,537597,117643346,0,0,0,117643346
2018-09-11,673083,117883753,0,0,0,117883753
2018-09-12,418903,118115995,0,0,0,118115995
2018-09-13,1307162,118310637,0,0,0,118310637
2018-09-14,439542,117348035,0,0,0,117348035
2018-09-17,855227,117008125,0,0,0,117008125
2018-09-18,2208953,117694151,0,0,0,117694151
2018-09-19,3391514,118282993,0,0,0,118282993
2018-09-20,998590,118816944,0,0,0,118816944
2018-09-21,2932363,117415918,0,0,0,117415918
2018-09-25,747972,117318708,0,0,0,117318708
2018-09-26,548193,117487152,0,0,0,117487152
2018-09-27,485919,117400605,0,0,0,117400605
2018-09-28,1015654,115240932,0,0,0,115240932
2018-10-08,1550739,115875152,0,0,0,115875152
2018-10-09,2492444,114659256,0,0,0,114659256
2018-10-10,519407,113946134,0,0,0,113946134
2018-10-11,2648569,108261715,0,0,0,108261715
2018-10-12,842203,107525753,0,0,0,107525753
2018-10-15,162319,106807763,0,0,0,106807763
2018-10-16,540333,106609206,0,0,0,106609206
2018-10-17,1391090,106911606,0,0,0,106911606
2018-10-18,103028,106563819,0,0,0,106563819
2018-10-19,2454897,107331246,0,0,0,107331246
2018-10-22,1977411,108141759,0,0,0,108141759
2018-10-23,3057437,107845400,0,0,0,107845400
2018-10-24,809414,107680833,0,0,0,107680833
2018-10-25,896954,107687906,0,0,0,107687906
2018-10-26,2146550,108215894,50000,50000,128500,108344394
2018-10-29,2718467,109305438,0,0,0,109305438
2018-10-30,1235176,108615629,0,0,0,108615629
2018-10-31,1961030,107090218,0,0,0,107090218
2018-11-01,1601397,107333816,0,0,0,107333816
2018-11-02,2644246,107059266,50000,50000,135500,107194766
2018-11-05,6236767,108927845,0,0,0,108927845
2018-11-06,4050734,109790975,50000,50000,142000,109932975
2018-11-07,4365774,109763714,0,0,0,109763714
2018-11-08,2814262,107835756,11700,11700,33696,107869452
2018-11-09,39017854,120764689,50300,62000,196540,120961229
2018-11-12,24361205,116526890,0,62000,216380,116743270
2018-11-13,71136938,138607495,0,62000,238080,138845575
2018-11-14,62349513,148913770,0,61800,236694,149150464
2018-11-15,72279434,147152901,300,62100,234117,147387018
2018-11-16,64703299,139447931,0,61900,248219,139696150
2018-11-19,54827523,143877804,0,61900,233982,144111786
2018-11-20,31170763,146060427,0,61800,226188,146286615
2018-11-21,28456906,141334316,200,12000,42480,141376796
2018-11-22,20282505,137575781,100,12100,41866,137617647
2018-11-23,20945432,126512804,0,12100,38357,126551161
2018-11-26,17226954,128275458,0,12100,38236,128313694
2018-11-27,17803091,122697819,0,10600,34450,122732269
2018-11-28,18505489,128472591,700,11300,36273,128508864
2018-11-29,23891725,135202863,150400,161700,502887,135705750
2018-11-30,9505269,133460779,0,61400,189726,133650505
2018-12-03,21115366,135511371,0,60700,194240,135705611
2018-12-04,12460966,123545284,50200,110900,360425,123905709
2018-12-05,7519140,118463642,50000,110900,352662,118816304
2018-12-06,4935050,116812196,500,61400,198936,117011132
2018-12-07,4699915,109170309,100,61500,202335,109372644
2018-12-10,9547111,109966760,0,11200,36176,110002936
2018-12-11,7144079,113255751,0,10600,34132,113289883
2018-12-12,3820141,111878388,700,11300,37064,111915452
2018-12-13,5104852,109271523,0,10700,35096,109306619
2018-12-14,2831035,107473721,200,10900,34553,107508274
2018-12-17,7934587,101234541,50000,60600,202404,101436945
2018-12-18,15093954,102071667,50000,50000,178500,102250167
2018-12-19,10058373,98235667,50000,100000,351000,98586667
2018-12-20,9108605,99014162,0,100000,349000,99363162
2018-12-21,5203214,95962286,0,100000,339000,96301286
2018-12-24,7497382,97786339,0,50000,173500,97959839
2018-12-25,4474245,97102168,150000,200000,686000,97788168
2018-12-26,9987813,101134218,0,100000,351000,101485218
2018-12-27,5825605,97494233,0,100000,351000,97845233
2018-12-28,3376890,93703099,0,50000,175500,93878599
2019-01-02,7269036,94364034,0,50000,178000,94542034
2019-01-03,4217977,93895248,0,50000,173500,94068748
2019-01-04,16886404,96016949,136200,186200,701974,96718923
2019-01-07,12083560,87688182,43800,100000,382000,88070182
2019-01-08,6446950,83631652,0,50000,191000,83822652
2019-01-09,6896965,83659270,0,50000,187000,83846270
2019-01-10,9991005,91093340,0,0,0,91093340
2019-01-11,5844758,87484992,210000,210000,795900,88280892
2019-01-14,5125629,89602279,0,100000,370000,89972279
2019-01-15,2029237,83597160,40000,140000,525000,84122160
2019-01-16,4092272,80136265,120000,220000,833800,80970065
2019-01-17,5152203,73310788,0,100000,383000,73693788
2019-01-18,7360235,77336049,0,100000,376000,77712049
2019-01-21,1867889,75191233,0,0,0,75191233
2019-01-22,2567372,76198131,0,0,0,76198131
2019-01-23,1044317,74450172,0,0,0,74450172
2019-01-24,1575227,74257275,0,0,0,74257275
2019-01-25,1590958,73441994,55000,55000,200750,73642744
2019-01-28,3380957,75392946,0,55000,199100,75592046
2019-01-29,2725531,75046800,0,0,0,75046800
2019-01-30,1758954,74074731,20000,20000,72600,74147331
2019-01-31,4497792,75914662,20000,20000,71000,75985662
2019-02-01,2327350,71469705,0,20000,71400,71541105
2019-02-11,6531690,72595922,0,20000,73800,72669722
2019-02-12,3047982,69069097,0,0,0,69069097
2019-02-13,4234631,68206009,50000,50000,186000,68392009
2019-02-14,4373182,70201342,0,0,0,70201342
2019-02-15,8076487,74038081,50000,50000,192500,74230581
2019-02-18,10356110,77256300,0,0,0,77256300
2019-02-19,4797774,74743896,0,0,0,74743896
2019-02-20,3246375,73348620,0,0,0,73348620
2019-02-21,4519886,74232836,0,0,0,74232836
2019-02-22,4154159,71974555,0,0,0,71974555
2019-02-25,31376719,93904720,0,0,0,93904720
2019-02-26,16526287,91225941,0,0,0,91225941
2019-02-27,38572800,107547720,70000,70000,306600,107854320
2019-02-28,13537283,106858984,0,0,0,106858984
2019-03-01,6837943,102794936,0,0,0,102794936
2019-03-04,23078058,108634888,0,0,0,108634888
2019-03-05,12628735,108218434,0,0,0,108218434
2019-03-06,22054982,108055022,0,0,0,108055022
2019-03-07,12680203,97657855,0,0,0,97657855
2019-03-08,11641591,92068644,0,0,0,92068644
2019-03-11,29912220,109412500,0,0,0,109412500
2019-03-12,23797776,112287213,0,0,0,112287213
2019-03-13,21181378,113070580,0,0,0,113070580
2019-03-14,18644907,111464106,0,0,0,111464106
2019-03-15,32587202,113635207,0,0,0,113635207
2019-03-18,29556878,118564348,0,0,0,118564348
2019-03-19,18268982,120169560,0,0,0,120169560
2019-03-20,11446411,121509311,100,100,431,121509742
2019-03-21,31188442,132961878,0,100,436,132962314
2019-03-22,11661034,127444474,0,100,437,127444911
2019-03-25,18142818,129437091,0,100,431,129437522
2019-03-26,8973601,128655910,0,100,417,128656327
2019-03-27,4643413,126985763,200,300,1239,126987002
2019-03-28,4013376,121897171,0,300,1215,121898386
2019-03-29,7774286,123625803,0,300,1239,123627042
2019-04-01,11099684,126080770,0,300,1287,126082057
2019-04-02,10282466,124537233,0,300,1284,124538517
2019-04-03,9604342,125832962,0,300,1290,125834252
2019-04-04,7379303,123071112,0,300,1308,123072420
2019-04-08,37695216,140100434,0,300,1362,140101796
2019-04-09,14602603,126041624,0,300,1416,126043040
2019-04-10,20834310,133815331,0,300,1431,133816762
2019-04-11,31503674,143219522,4600,4900,24353,143243875
2019-04-12,14422202,150025307,0,4900,26803,150052110
2019-04-15,107536604,194251405,50000,54900,302499,194553904
2019-04-16,40209598,175092864,0,4900,26852,175119716
2019-04-17,46552227,179272064,20000,24900,140436,179412500
2019-04-18,72762753,197637757,70000,74900,464380,198102137
2019-04-19,75827597,197820762,20000,44900,284666,198105428
2019-04-22,56089534,199590350,0,24900,149151,199739501
2019-04-23,46102567,211613520,0,4900,28371,211641891
2019-04-24,20530834,185094396,0,4900,28910,185123306
2019-04-25,23907057,176429473,0,300,1665,176431138
2019-04-26,14406739,164174356,74600,74900,426181,164600537
2019-04-29,17150027,162421411,0,4900,26999,162448410
2019-04-30,15511663,154124416,0,4900,27048,154151464
2019-05-06,25962016,159714088,0,4900,24941,159739029
2019-05-07,16415530,157895121,20000,24900,130476,158025597
2019-05-08,31031631,168872989,0,24900,123255,168996244
2019-05-09,7359684,164085373,0,4900,24059,164109432
2019-05-10,25090150,162074155,0,4900,25676,162099831
2019-05-13,19438812,170674813,0,4900,24549,170699362
2019-05-14,11447835,172597014,0,4900,24255,172621269
2019-05-15,17853862,167386940,20000,24900,126990,167513930
2019-05-16,13972715,165664537,0,4900,24892,165689429
2019-05-17,11347925,161952626,0,4900,24402,161977028
2019-05-20,17792833,165217757,0,4900,23569,165241326
2019-05-21,10326874,164781939,0,4900,23912,164805851
2019-05-22,10702511,158295470,0,4600,23184,158318654
2019-05-23,10436524,159494929,0,4600,22126,159517055
2019-05-24,7268464,153305809,0,4600,21942,153327751
2019-05-27,8944752,151899056,0,4600,23138,151922194
2019-05-28,10187141,148491365,0,4600,23276,148514641
2019-05-29,5547491,148900672,0,4600,23276,148923948
2019-05-30,8178569,149085849,0,4600,22724,149108573
2019-05-31,26429781,156629823,0,4600,24104,156653927
2019-06-03,24784019,140244222,300,4900,26950,140271172
2019-06-04,16010650,140282807,0,4600,25668,140308475
2019-06-05,21276230,146161458,300,4900,26068,146187526
2019-06-06,15897306,149262369,0,4900,25578,149287947
2019-06-10,17071768,148842197,30000,34900,190554,149032751
2019-06-11,13393248,143954354,0,4900,27293,143981647
2019-06-12,10771445,145498702,0,4900,26950,145525652
2019-06-13,24737021,150990312,0,4900,28077,151018389
2019-06-14,14194122,145962074,0,4900,26656,145988730
2019-06-17,12702411,151492202,0,4900,27097,151519299
2019-06-18,8932418,151851231,0,4900,26264,151877495
2019-06-19,28226744,164877726,0,4900,27538,164905264
2019-06-20,22396888,162974582,0,4900,28028,163002610
2019-06-21,39636795,168268748,0,4900,29351,168298099
2019-06-24,26271449,180201873,0,4900,28567,180230440
2019-06-25,19803918,187045296,0,4900,28714,187074010
2019-06-26,9255332,183623028,0,4900,28224,183651252
2019-06-27,9343208,169381857,15000,19900,114425,169496282
2019-06-28,16310810,168973005,0,19900,112833,169085838
2019-07-01,16433470,169477794,0,19900,115818,169593612
2019-07-02,11763780,167584652,0,19900,113032,167697684
2019-07-03,11959395,163901436,0,19900,109251,164010687
2019-07-04,4598549,162138732,0,19900,110246,162248978
2019-07-05,4360018,157034377,0,19900,111241,157145618
2019-07-08,21674056,164290831,0,19900,103878,164394709
2019-07-09,24910308,167217419,0,19900,109649,167327068
2019-07-10,15933464,167841881,0,19900,104475,167946356
2019-07-11,5807946,165503168,0,19900,102485,165605653
2019-07-12,5344746,166549639,0,19900,102883,166652522
2019-07-15,14448802,175429281,0,19900,102286,175531567
2019-07-16,6968883,176582439,0,19900,103480,176685919
2019-07-17,6253056,177261264,0,19900,102684,177363948
2019-07-18,6897209,176282948,0,19900,102684,176385632
2019-07-19,7048152,174230776,0,19900,101888,174332664
2019-07-22,5081878,172454742,0,19900,99301,172554043
2019-07-23,4434226,173850528,0,4900,24892,173875420
2019-07-24,9409458,174089992,0,4900,25480,174115472
2019-07-25,7544368,175609929,0,4900,24941,175634870
2019-07-26,5313135,177135184,0,4900,25039,177160223
2019-07-29,5998882,173718284,0,4900,25431,173743715
2019-07-30,3954673,174322329,0,4900,25333,174347662
2019-07-31,3576446,173686058,0,4900,25235,173711293
2019-08-01,8229654,173702311,0,4900,25529,173727840
2019-08-02,8836671,162497035,0,4900,25039,162522074
2019-08-05,5882793,157959969,0,4900,25480,157985449
2019-08-06,6327046,154998931,0,4900,25284,155024215
2019-08-07,13110787,151484709,0,4900,26509,151511218
2019-08-08,9218096,149725304,0,4900,26705,149752009
2019-08-09,9903863,148010763,0,4900,25921,148036684
2019-08-12,7190916,150180087,0,4900,25921,150206008
2019-08-13,10763521,146220592,0,4900,26705,146247297
2019-08-14,10580832,144178207,0,4900,27440,144205647
2019-08-15,14391344,139933751,0,4900,28077,139961828
2019-08-16,13847678,138612415,0,4900,27783,138640198
2019-08-19,15532221,143616953,0,4900,27930,143644883
2019-08-20,13286580,147238227,0,4900,27440,147265667
2019-08-21,6508703,148148952,0,4900,27636,148176588
2019-08-22,6009509,141229611,1800,6700,38793,141268404
2019-08-23,8866995,141988309,5600,12300,69126,142057435
2019-08-26,6511768,143196188,0,12300,67773,143263961
2019-08-27,4982789,140971288,0,12300,68880,141040168
2019-08-28,6411091,140884787,0,12300,68142,140952929
2019-08-29,11051110,145314061,0,12300,66051,145380112
2019-08-30,9356842,138515250,0,12300,65313,138580563
2019-09-02,6017698,135374699,0,12300,66912,135441611
2019-09-03,5262539,131013629,0,12300,66912,131080541
2019-09-04,3313368,131169857,0,12300,67527,131237384
2019-09-05,15815120,138699975,0,7400,40552,138740527
2019-09-06,16409520,138661521,0,7400,40034,138701555
2019-09-09,5774344,135508389,0,7400,39812,135548201
2019-09-10,3917920,135539207,0,7400,39812,135579019
2019-09-11,5701198,137647630,0,7400,39294,137686924
2019-09-12,6348931,139093046,0,7400,39442,139132488
2019-09-16,3980845,136531875,0,7400,39960,136571835
2019-09-17,5862288,137518778,0,7400,39072,137557850
2019-09-18,2091019,137065365,0,7400,39516,137104881
2019-09-19,4070613,132884100,0,7400,39960,132924060
2019-09-20,3208725,131803477,0,7400,39812,131843289
2019-09-23,26378879,146419895,0,7400,41810,146461705
2019-09-24,12398374,147459315,0,7400,40922,147500237
2019-09-25,6652226,145305573,0,7400,40108,145345681
2019-09-26,17319191,153300382,0,7400,38110,153338492
2019-09-27,16296479,157422088,0,7400,35076,157457164
2019-09-30,13187786,160274966,0,7400,33892,160308858
2019-10-08,6332588,155123133,0,7400,34928,155158061
2019-10-09,2280749,147682033,0,7400,35890,147717923
2019-10-10,3861438,145077694,0,7400,37000,145114694
2019-10-11,14885175,146519879,0,7400,37444,146557323
2019-10-14,9700653,147278393,0,7400,37370,147315763
2019-10-15,6654207,146756206,0,0,0,146756206
2019-10-16,1821333,145141169,1400,1400,7014,145148183
2019-10-17,8480769,145406425,500,1900,9747,145416172
2019-10-18,4571374,140803581,2600,4500,22680,140826261
2019-10-21,5381741,141836850,0,4500,22230,141859080
2019-10-22,3220061,138211343,0,4500,22230,138233573
2019-10-23,4651947,138264587,0,4500,22050,138286637
2019-10-24,8831943,139965943,1500,6000,28560,139994503
2019-10-25,1258786,133250138,0,6000,29580,133279718
2019-10-28,4784462,136333890,1400,7400,36778,136370668
2019-10-29,4587084,137552737,0,7400,36334,137589071
2019-10-30,8092882,138419037,0,7400,35298,138454335
2019-10-31,3919272,137944287,0,7400,35594,137979881
2019-11-01,2639715,135694314,0,7400,36038,135730352
2019-11-04,5543617,134223566,0,7400,36704,134260270
2019-11-05,3032505,134331844,0,7400,36482,134368326
2019-11-06,2076286,133093370,0,7400,36630,133130000
2019-11-07,2986237,134405008,0,7400,36482,134441490
2019-11-08,5801064,132792067,0,7400,36038,132828105
2019-11-11,6525095,135658203,0,7400,35594,135693797
2019-11-12,2736366,136979961,0,7400,35446,137015407
2019-11-13,6387405,141257408,0,7400,35520,141292928
2019-11-14,1051192,135601711,0,7400,35372,135637083
2019-11-15,3432661,133894050,0,7400,35076,133929126
2019-11-18,3117995,132189526,0,7400,34928,132224454
2019-11-19,674444,128874866,0,7400,35594,128910460
2019-11-20,4236844,128938486,0,7400,35890,128974376
2019-11-21,4088968,131824162,0,7400,35372,131859534
2019-11-22,2430461,128733885,0,7400,35076,128768961
2019-11-25,4280694,129807644,0,7400,35520,129843164
2019-11-26,3555311,129085597,0,7400,35816,129121413
2019-11-27,5308826,131068572,0,7400,35150,131103722
2019-11-28,4878483,131313431,0,7400,34854,131348285
2019-11-29,2050138,131438711,0,7400,34632,131473343
2019-12-02,2584956,130513047,0,7400,34780,130547827
2019-12-03,3450409,131088519,0,7400,34632,131123151
2019-12-04,6276416,134158351,0,7400,34188,134192539
2019-12-05,1556404,132648795,0,7400,34336,132683131
2019-12-06,6257849,132953766,0,7400,33966,132987732
2019-12-09,4885064,134087530,0,0,0,134087530
2019-12-10,4725236,135936252,0,0,0,135936252
2019-12-11,1737769,134514215,0,0,0,134514215
2019-12-12,2628186,135360026,0,0,0,135360026
2019-12-13,5255719,136858160,0,0,0,136858160
2019-12-16,6952430,137442056,0,0,0,137442056
2019-12-17,5010373,135519440,0,0,0,135519440
2019-12-18,3834809,132082333,0,0,0,132082333
2019-12-19,2211910,131717810,0,0,0,131717810
2019-12-20,3397394,131788115,0,0,0,131788115
2019-12-23,6499927,133190423,0,0,0,133190423
2019-12-24,8445620,138643785,0,0,0,138643785
2019-12-25,7425056,142448425,0,0,0,142448425
2019-12-26,2459359,143367795,0,0,0,143367795
2019-12-27,3384899,139835151,0,0,0,139835151
2019-12-30,9006821,141377223,0,0,0,141377223
2019-12-31,5415808,140753989,0,0,0,140753989
2020-01-02,6174231,138943545,0,0,0,138943545
2020-01-03,10282376,143194078,0,0,0,143194078
2020-01-06,13790510,148117633,0,0,0,148117633
2020-01-07,7171984,143611024,0,0,0,143611024
2020-01-08,22911122,140792812,383200,383200,1854688,142647500
2020-01-09,22975150,146645060,0,0,0,146645060
2020-01-10,6196232,147065898,0,0,0,147065898
2020-01-13,13067435,151353938,0,0,0,151353938
2020-01-14,16599262,157245332,0,0,0,157245332
2020-01-15,8623116,160902519,0,0,0,160902519
2020-01-16,6873281,159470377,0,0,0,159470377
2020-01-17,3721719,159512028,0,0,0,159512028
2020-01-20,4657791,160423048,0,0,0,160423048
2020-01-21,8857400,164652086,0,0,0,164652086
2020-01-22,7543527,163118057,0,0,0,163118057
2020-01-23,4942204,156368949,0,0,0,156368949
2020-02-03,5873352,158157604,0,0,0,158157604
2020-02-04,13744065,158885968,0,0,0,158885968
2020-02-05,6439941,157452243,0,0,0,157452243
2020-02-06,6333865,152968787,0,0,0,152968787
2020-02-07,6378102,154634761,0,0,0,154634761
2020-02-10,11240681,155206982,0,0,0,155206982
2020-02-11,9999688,155762591,0,0,0,155762591
2020-02-12,3492040,149304394,0,0,0,149304394
2020-02-13,6621621,145792274,0,0,0,145792274
2020-02-14,3297141,144480081,0,0,0,144480081
2020-02-17,12471885,144098569,0,0,0,144098569
2020-02-18,4960341,142649244,0,0,0,142649244
2020-02-19,3671156,139714647,0,0,0,139714647
2020-02-20,5322118,138751001,1000,1000,4290,138755291
2020-02-21,4761056,138988199,0,1000,4300,138992499
2020-02-24,7022996,133962019,0,1000,4230,133966249
2020-02-25,9086590,134425297,22200,23200,95352,134520649
2020-02-26,8231446,136849745,0,1000,4120,136853865
2020-02-27,4018659,134334515,13000,14000,58100,134392615
2020-02-28,5488408,135571664,0,0,0,135571664
2020-03-02,5663181,134140403,0,0,0,134140403
2020-03-03,5810296,131705672,0,0,0,131705672
2020-03-04,6425323,129022219,2000,2000,8500,129030719
2020-03-05,9839269,127867418,0,2000,8660,127876078
2020-03-06,6339685,122895390,0,2000,8520,122903910
2020-03-09,12614533,127294955,0,0,0,127294955
2020-03-10,16559508,125992084,220000,220000,952600,126944684
2020-03-11,13240355,129112385,0,51200,215040,129327425
2020-03-12,10804868,134617077,0,0,0,134617077
2020-03-13,9406723,136941191,0,0,0,136941191
2020-03-16,5787419,134173259,0,0,0,134173259
2020-03-17,3698673,135051561,0,0,0,135051561
2020-03-18,6026215,133758979,0,0,0,133758979
2020-03-19,7274975,139042354,0,0,0,139042354
2020-03-20,1652940,133900979,0,0,0,133900979
2020-03-23,4426688,135551232,0,0,0,135551232
2020-03-24,2987149,132382997,0,0,0,132382997
2020-03-25,7040157,134920657,0,0,0,134920657
2020-03-26,2427052,133885102,0,0,0,133885102
2020-03-27,5679491,135706061,500,500,2000,135708061
2020-03-30,2550177,134145458,0,0,0,134145458
2020-03-31,3092256,135285698,0,0,0,135285698
2020-04-01,2867326,131261833,0,0,0,131261833
2020-04-02,2097763,129678840,0,0,0,129678840
2020-04-03,1993060,129390049,0,0,0,129390049
2020-04-07,4043962,128768021,0,0,0,128768021
2020-04-08,5901544,128685240,0,0,0,128685240
2020-04-09,1894605,128168910,0,0,0,128168910
2020-04-10,3626672,126855392,0,0,0,126855392
2020-04-13,2719969,128157699,0,0,0,128157699
2020-04-14,2305505,129171163,0,0,0,129171163
2020-04-15,2340899,130050272,0,0,0,130050272
2020-04-16,2996015,128363351,330000,330000,1296900,129660251
2020-04-17,2715503,126815825,0,0,0,126815825
2020-04-20,1405594,126141284,0,0,0,126141284
2020-04-21,1688842,124472463,0,0,0,124472463
2020-04-22,4003645,125195370,0,0,0,125195370
2020-04-23,1965394,125432221,0,0,0,125432221
2020-04-24,890529,125311601,0,0,0,125311601
2020-04-27,3686544,126713498,0,0,0,126713498
2020-04-28,13360594,134223193,0,0,0,134223193
2020-04-29,7638911,123972433,0,0,0,123972433
2020-04-30,3832260,113604621,0,0,0,113604621
2020-05-06,0,112740383,0,0,0,112740383
2020-05-07,0,112255168,0,0,0,112255168
2020-05-08,0,111627198,0,0,0,111627198
2020-05-11,0,111211895,0,0,0,111211895
2020-05-12,0,110439853,0,0,0,110439853
2020-05-13,0,110177248,0,0,0,110177248
2020-05-14,0,109192089,0,0,0,109192089
2020-05-15,0,107687748,0,0,0,107687748
2020-05-18,0,107523232,0,0,0,107523232
2020-05-19,0,107218443,0,0,0,107218443
2020-05-20,10394242,103309291,430700,430700,1791712,105101003
2020-05-21,17190268,116031298,0,0,0,116031298
2020-05-22,4318408,115017739,0,0,0,115017739
2020-05-25,4712004,117565235,0,0,0,117565235
2020-05-26,6103093,121807182,0,0,0,121807182
2020-05-27,1598625,120973756,0,0,0,120973756
2020-05-28,3655642,121574320,33300,33300,126873,121701193
2020-05-29,2709374,121190026,133200,133200,512820,121702846
2020-06-01,4357927,123118113,0,0,0,123118113
2020-06-02,3224237,121987059,66600,66600,257076,122244135
2020-06-03,5473760,125430831,0,0,0,125430831
2020-06-04,4284697,126825636,66600,66600,255744,127081380
2020-06-05,1496327,124120633,33300,33300,127872,124248505
2020-06-08,6498447,127003777,0,0,0,127003777
2020-06-09,2610015,127776053,0,0,0,127776053
2020-06-10,2679517,127462106,66600,66600,251082,127713188
2020-06-11,3314283,127930160,0,0,0,127930160
2020-06-12,972942,126766390,0,0,0,126766390
2020-06-15,2831397,128339293,0,0,0,128339293
2020-06-16,1597879,127941115,0,0,0,127941115
2020-06-17,2813400,129300802,0,0,0,129300802
2020-06-18,1485895,129318727,0,0,0,129318727
2020-06-19,3417558,130974360,0,0,0,130974360
2020-06-22,3496327,133412707,0,0,0,133412707
2020-06-23,1107989,132914693,0,0,0,132914693
2020-06-24,1446100,132639385,0,0,0,132639385
2020-06-29,2202161,133671803,0,0,0,133671803
2020-06-30,1163841,132391968,0,0,0,132391968
2020-07-01,1052139,131502443,0,0,0,131502443
2020-07-02,2653359,128644788,0,0,0,128644788
2020-07-03,3816276,116683513,0,0,0,116683513
2020-07-06,12286708,116686006,0,0,0,116686006
2020-07-07,9366895,115016441,0,0,0,115016441
2020-07-08,14089504,120652430,114100,114100,470092,121122522
2020-07-09,11407934,117829443,0,0,0,117829443
2020-07-10,13282741,123180622,0,0,0,123180622
2020-07-13,12421402,126003619,13600,13600,54536,126058155
2020-07-14,6512428,126851502,0,13600,53992,126905494
2020-07-15,13662097,132421984,0,13600,53720,132475704
2020-07-16,6524452,130629562,0,13600,52768,130682330
2020-07-17,2673083,128869457,0,13600,52496,128921953
2020-07-20,3406906,127715523,5700,9200,36340,127751863
2020-07-21,2817429,127901662,0,9200,36156,127937818
2020-07-22,3416082,127063237,0,9200,36248,127099485
2020-07-23,5781491,127483967,400,9600,37344,127521311
2020-07-24,3764138,127286378,0,9600,36384,127322762
2020-07-27,3931386,129565986,0,9600,36192,129602178
2020-07-28,773290,128136966,9600,15300,57834,128194800
2020-07-29,6285873,132615293,0,15300,58446,132673739
2020-07-30,4540513,133107000,0,14900,57812,133164812
2020-07-31,4806542,135562954,0,14900,57514,135620468
2020-08-03,4811464,134291034,0,14900,57812,134348846
2020-08-04,3732241,134352560,0,14900,57663,134410223
2020-08-05,7518123,136380369,0,4900,18914,136399283
2020-08-06,4692509,139573014,0,4900,18865,139591879
2020-08-07,2456147,139023389,0,4900,18718,139042107
2020-08-10,16867111,150326331,0,4900,19208,150345539
2020-08-11,5822377,150765875,0,4900,18963,150784838
2020-08-12,19861101,164383707,2500,7400,29526,164413233
2020-08-13,10118189,164494948,0,4900,19404,164514352
2020-08-14,6527033,159825185,0,4900,19453,159844638
2020-08-17,6678016,156133002,0,0,0,156133002
2020-08-18,6266036,155597445,0,0,0,155597445
2020-08-19,18741098,148326332,397500,397500,1621800,149948132
2020-08-20,8172949,143406598,0,0,0,143406598
2020-08-21,7233664,146659840,0,0,0,146659840
2020-08-24,2972282,146866196,0,0,0,146866196
2020-08-25,3393076,143020342,0,0,0,143020342
2020-08-26,2655782,142008079,0,0,0,142008079
2020-08-27,3988716,143546590,0,0,0,143546590
2020-08-28,2164634,143701099,0,0,0,143701099
2020-08-31,6815498,143980233,0,0,0,143980233
2020-09-01,5603121,146772253,0,0,0,146772253
2020-09-02,2551927,145553928,3000,3000,11700,145565628
2020-09-03,2443230,146718124,0,0,0,146718124
2020-09-04,1610422,145973166,0,0,0,145973166
2020-09-07,3759687,144095258,0,0,0,144095258
2020-09-08,2352479,138943637,0,0,0,138943637
2020-09-09,5135326,138079680,0,0,0,138079680
2020-09-10,7593151,139696807,0,0,0,139696807
2020-09-11,1130746,138423363,0,0,0,138423363
2020-09-14,1372813,138514999,0,0,0,138514999
2020-09-15,881407,138807462,0,0,0,138807462
2020-09-16,2326272,140378550,0,0,0,140378550
2020-09-17,2534832,141218642,0,0,0,141218642
2020-09-18,1352973,138005200,0,0,0,138005200
2020-09-21,1782178,137826070,0,0,0,137826070
2020-09-22,2243642,136561233,0,0,0,136561233
2020-09-23,1399729,129843106,0,0,0,129843106
2020-09-24,1686765,126224149,0,0,0,126224149
2020-09-25,1061157,125562872,0,0,0,125562872
2020-09-28,1002133,125023563,0,0,0,125023563
2020-09-29,961610,124385461,0,0,0,124385461
2020-09-30,1134295,121977545,0,0,0,121977545
2020-10-09,1735731,122764911,0,0,0,122764911
2020-10-12,2832710,122258835,0,0,0,122258835
2020-10-13,4400718,121877907,0,0,0,121877907
2020-10-14,5480129,119653109,0,0,0,119653109
2020-10-15,3988389,118086087,0,0,0,118086087
2020-10-16,1786500,118003697,0,0,0,118003697
2020-10-19,6212746,121580715,0,0,0,121580715
2020-10-20,1658426,117656660,0,0,0,117656660
2020-10-21,674747,117833816,10000,10000,37500,117871316
2020-10-22,1035221,118025428,0,10000,37300,118062728
2020-10-23,1345622,117506656,0,10000,37300,117543956
2020-10-26,6641616,113715598,0,0,0,113715598
2020-10-27,576207,112243621,0,0,0,112243621
2020-10-28,2159424,113103003,0,0,0,113103003
2020-10-29,1266884,112150211,0,0,0,112150211
2020-10-30,2580095,111979231,0,0,0,111979231
2020-11-02,2720616,112833519,0,0,0,112833519
2020-11-03,1661478,110822725,0,0,0,110822725
2020-11-04,3634222,111798188,0,0,0,111798188
2020-11-05,4187413,109933603,0,0,0,109933603
2020-11-06,4036051,104644314,0,0,0,104644314
2020-11-09,9021915,106373302,0,0,0,106373302
2020-11-10,1332139,106408461,0,0,0,106408461
2020-11-11,1890152,103202132,0,0,0,103202132
2020-11-12,1073156,103206757,0,0,0,103206757
2020-11-13,435501,101489373,0,0,0,101489373
2020-11-16,2849652,100998739,0,0,0,100998739
2020-11-17,4252639,102440377,0,0,0,102440377
2020-11-18,2475112,103104190,0,0,0,103104190
2020-11-19,11016984,98566947,373800,373800,1431654,99998601
2020-11-20,9644659,102794631,0,0,0,102794631
2020-11-23,6405898,104658126,0,0,0,104658126
2020-11-24,6104320,105824171,0,0,0,105824171
2020-11-25,4615366,104175643,100000,100000,380000,104555643
2020-11-26,26201382,107672669,312200,412200,1722996,109395665
2020-11-27,31418260,122701558,300,300,1215,122702773
2020-11-30,18838698,120787865,0,0,0,120787865
2020-12-01,16052603,126679996,0,0,0,126679996
2020-12-02,13371428,123811112,0,0,0,123811112
2020-12-03,10670623,124693664,0,0,0,124693664
2020-12-04,6430666,118823891,0,0,0,118823891
2020-12-07,8041189,118766237,0,0,0,118766237
2020-12-08,3830865,117621715,0,0,0,117621715
2020-12-09,13749404,120559243,0,0,0,120559243
2020-12-10,6525473,119714426,0,0,0,119714426
2020-12-11,4783085,119537356,0,0,0,119537356
2020-12-14,5263848,119685486,0,0,0,119685486
2020-12-15,3945255,118591814,0,0,0,118591814
2020-12-16,3467639,119304679,0,0,0,119304679
2020-12-17,6814689,117307888,200000,200000,752000,118059888
2020-12-18,14294912,122236042,0,0,0,122236042
2020-12-21,12963521,122429124,129800,129800,514008,122943132
2020-12-22,10401822,123528344,61000,61000,236070,123764414
2020-12-23,32858777,135782257,351500,412500,1720125,137502382
2020-12-24,39837608,154111854,0,402500,1626100,155737954
2020-12-25,51137902,165275676,37600,440100,1874826,167150502
2020-12-28,26370183,156446180,0,440100,1844019,158290199
2020-12-29,27529243,156855144,0,400100,1580395,158435539
2020-12-30,11588156,145326767,0,352500,1413525,146740292
2020-12-31,9082165,141895321,0,311000,1250220,143145541
2021-01-04,14708574,140496667,0,311000,1247110,141743777
2021-01-05,8231253,139163560,0,0,0,139163560
2021-01-06,25121291,138306448,405100,405100,1689267,139995715
2021-01-07,28479352,145953020,0,325100,1297149,147250169
2021-01-08,16580608,147922228,0,27600,107364,148029592
2021-01-11,17895821,153731164,0,27600,102396,153833560
2021-01-12,6592745,150413709,0,27600,103500,150517209
2021-01-13,6837039,144233002,0,27600,104328,144337330
2021-01-14,6613188,145825159,0,27600,103224,145928383
2021-01-15,4855336,143564616,0,27600,104052,143668668
2021-01-18,9754764,141412012,17900,45500,176085,141588097
2021-01-19,16315880,147645736,0,31600,120396,147766132
2021-01-20,8145393,144483850,0,31600,118816,144602666
2021-01-21,10288334,144132569,0,31600,118500,144251069
2021-01-22,6887767,136921157,250000,281600,1047552,137968709
2021-01-25,12701058,137781174,0,281600,1070080,138851254
2021-01-26,3563828,137269182,0,131600,497448,137766630
2021-01-27,15844478,137567364,0,31600,119132,137686496
2021-01-28,0,136365677,0,31600,119132,136484809
2021-01-29,12082271,136203466,0,31600,114076,136317542
2021-02-01,7936639,138627083,0,4000,14080,138641163
2021-02-02,6203314,139734039,0,4000,14240,139748279
2021-02-03,7253178,141546066,0,4000,13720,141559786
2021-02-04,9106924,134181434,0,4000,13520,134194954
2021-02-05,2743939,135418388,0,4000,13320,135431708
2021-02-08,1020380,133976504,0,4000,13320,133989824
2021-02-09,8692450,135155533,0,4000,13560,135169093
2021-02-10,2992334,133384397,0,4000,13480,133397877
2021-02-18,3756440,130362618,0,4000,13760,130376378
2021-02-19,2988833,123045761,0,4000,14000,123059761
2021-02-22,13145838,124838758,0,4000,14240,124852998
2021-02-23,2334911,124045031,0,4000,14240,124059271
2021-02-24,5030738,127103878,0,4000,14120,127117998
2021-02-25,3609065,127539448,0,4000,14240,127553688
2021-02-26,4115592,123367451,0,4000,14240,123381691
2021-03-01,11426973,124270172,28900,28900,107219,124377391
2021-03-02,10100323,115601579,257300,284900,1105412,116706991
2021-03-03,18895049,116362082,52100,171800,680328,117042410
2021-03-04,11574918,119655118,120000,291800,1146774,120801892
2021-03-05,23988974,128949962,88300,320100,1270797,130220759
2021-03-08,26240922,126827894,90000,410100,1693713,128521607
2021-03-09,16171277,125436584,0,381800,1489020,126925604
2021-03-10,17420942,122301781,58300,440100,1888029,124189810
2021-03-11,46953276,137874217,0,440100,2077272,139951489
2021-03-12,155601652,189893828,0,440100,2284119,192177947
2021-03-15,140306040,187782327,0,440100,2288520,190070847
2021-03-16,236169562,272562724,0,440100,2517372,275080096
2021-03-17,110463423,191739822,0,440100,2297322,194037144
2021-03-18,126029828,215471527,0,440100,2526174,217997701
2021-03-19,133399655,264477610,0,440100,2777031,267254641
2021-03-22,6100954,253364463,0,440100,3054294,256418757
2021-03-23,0,236389078,0,440100,3357963,239747041
2021-03-24,236206987,372036980,0,440100,3692439,375729419
2021-03-25,292679261,348859112,0,440100,3366765,352225877
2021-03-26,272328624,366066817,0,440100,3529602,369596419
2021-03-29,320670204,432196844,0,440100,3701241,435898085
2021-03-30,293150563,384886377,0,440100,4062123,388948500
2021-03-31,222849511,345148363,0,440100,3657231,348805594
2021-04-01,209932859,375645661,0,440100,3472389,379118050
2021-04-02,192554509,393760632,0,440100,3353562,397114194
2021-04-06,179156172,406014342,0,440100,3688038,409702380
2021-04-07,134370573,424178942,0,440100,4057722,428236664
2021-04-08,518549731,599081864,0,440100,4462614,603544478
2021-04-09,262696229,624543230,0,440100,4907115,629450345
2021-04-12,222797192,585411419,0,440100,5400027,590811446
2021-04-13,540236239,641726937,0,440100,5188779,646915716
2021-04-14,342305981,577440887,0,440100,4968729,582409616
2021-04-15,267632822,499113814,0,440100,4555035,503668849
2021-04-16,276289491,494611786,0,412500,4380750,498992536
2021-04-19,321932640,538594835,0,412500,4549875,543144710
2021-04-20,472956117,611123059,22600,435100,5260359,616383418
2021-04-21,253917448,545710965,0,435100,4733888,550444853
2021-04-22,204005650,572546441,0,435100,4738239,577284680
2021-04-23,184098939,463175022,9100,444200,4899526,468074548
2021-04-26,208288953,529071886,4600,448800,4779720,533851606
2021-04-27,113017284,422097886,0,448800,4303992,426401878
2021-04-28,146319680,414568006,0,448800,4124472,418692478
2021-04-29,114118722,419597651,22700,471500,4196350,423794001
2021-04-30,175113752,434638183,6400,476800,4124320,438762503
2021-05-06,212083862,487720909,2500,479300,4352044,492072953
2021-05-07,116466443,458012506,0,478200,4193814,462206320
2021-05-10,161756143,454117875,0,478200,4365966,458483841
2021-05-11,283892187,472442604,21100,499300,5012972,477455576
2021-05-12,173703281,494393726,0,498600,4811490,499205216
2021-05-13,130262746,465832136,0,498600,4676868,470509004
2021-05-14,110655303,465657171,700,498600,4617036,470274207
2021-05-17,84665001,464687688,0,498200,4533620,469221308
2021-05-18,175511748,485299627,1100,499000,4870240,490169867
2021-05-19,245250609,530361420,300,479300,5147682,535509102
2021-05-20,298120624,455101277,20000,499300,5657069,460758346
2021-05-21,319409763,463015810,0,499300,6181334,469197144
2021-05-24,269394664,482279818,0,499300,5692020,487971838
2021-05-25,177867619,482593860,0,499300,5522258,488116118
2021-05-26,159518406,495900850,0,499300,6076481,501977331
2021-05-27,363638327,561974782,0,499300,6685627,568660409
2021-05-28,364912007,556338126,0,499300,6665655,563003781
2021-05-31,396637713,625980600,0,499300,6790480,632771080
2021-06-01,204808320,590470866,0,480400,6125100,596595966
2021-06-02,270760119,632409090,15600,496000,6785280,639194370
2021-06-03,162056652,570455366,3000,490000,6272000,576727366
2021-06-04,111190937,544217692,0,487000,5805040,550022732
2021-06-07,79526919,523306038,1900,488900,5949913,529255951
2021-06-08,182100749,577111275,0,488900,6165029,583276304
2021-06-09,86534944,533693588,0,488900,5984136,539677724
2021-06-10,112512354,544950788,0,488900,5896134,550846922
2021-06-11,156922763,548429951,0,488900,6003692,554433643
2021-06-15,102625692,528751671,0,488900,5666351,534418022
2021-06-16,71674272,477388500,0,488900,5099227,482487727
2021-06-17,49098629,468575175,0,487400,5054338,473629513
2021-06-18,75438798,475444882,200,487600,5163684,480608566
2021-06-21,132620833,509955908,0,482600,5438902,515394810
2021-06-22,180965921,526890525,5000,474600,5661978,532552503
2021-06-23,160178653,527218032,0,460100,5558008,532776040
2021-06-24,118544267,517938789,0,460100,5470589,523409378
2021-06-25,153714196,552070415,0,460100,5654629,557725044
2021-06-28,146207509,567206658,0,460100,5571811,572778469
2021-06-29,80760804,481463011,0,445100,5002924,486465935
2021-06-30,40837043,467553044,0,445100,4985120,472538164
2021-07-01,56106255,457012993,0,445100,4682452,461695445
2021-07-02,63431842,471758349,10000,455100,4892325,476650674
2021-07-05,39159450,464492899,0,455100,4805856,469298755
2021-07-06,160242421,526187624,0,455100,5288262,531475886
2021-07-07,145149151,540914577,0,455100,5215446,546130023
2021-07-08,111104000,504374053,20000,475100,5406638,509780691
2021-07-09,78720669,489334510,0,455100,5138079,494472589
2021-07-12,63162965,492328602,30000,475100,5397136,497725738
2021-07-13,237460328,546359157,10000,465100,5813750,552172907
2021-07-14,365559502,537168515,20000,485100,6490638,543659153
2021-07-15,175806753,535863897,0,475100,5914995,541778892
2021-07-16,137604174,511469186,0,465100,5632361,517101547
2021-07-19,117456396,518989905,40000,505100,5753089,524742994
2021-07-20,69384268,501674883,0,485100,5491332,507166215
2021-07-21,93759170,519424174,20000,505100,5844007,525268181
2021-07-22,131026889,519193967,0,485100,5724180,524918147
2021-07-23,78464440,481230815,20000,505100,5586406,486817221
2021-07-26,62138887,484669589,0,495100,5515414,490185003
2021-07-27,60227380,467191795,10000,495100,5277766,472469561
2021-07-28,37532859,409511368,10000,495100,4812372,414323740
2021-07-29,37182843,401688203,0,455100,4537347,406225550
2021-07-30,39640168,398271351,40000,495100,5005461,403276812
2021-08-02,62523231,407494074,20000,495100,5104481,412598555
2021-08-03,34123261,380782201,0,485100,4773384,385555585
2021-08-04,32387186,382834643,30000,505100,5081306,387915949
2021-08-05,30368834,371823286,10000,505100,4980286,376803572
2021-08-06,29723486,365241501,10000,505100,4884317,370125818
2021-08-09,21975511,359144074,20000,515100,4996470,364140544
2021-08-10,34933475,371207543,0,495100,4807421,376014964
2021-08-11,72639851,377383090,30000,485100,4962573,382345663
2021-08-12,39552284,378239326,0,465100,4613792,382853118
2021-08-13,34245772,376412339,20000,485100,4763682,381176021
2021-08-16,31180430,371482642,40000,495100,4921294,376403936
2021-08-17,28307675,360610334,0,495100,4787617,365397951
2021-08-18,20801852,344607239,0,494800,4557108,349164347
2021-08-19,19701536,333642549,20000,514500,4584195,338226744
2021-08-20,17356577,323987950,0,514500,4434990,328422940
2021-08-23,13119616,316593809,0,454500,4004145,320597954
2021-08-24,26659308,325618454,70000,524500,4641825,330260279
2021-08-25,17834742,322320545,400,494900,4404610,326725155
2021-08-26,21586349,321514510,20000,474500,4099680,325614190
2021-08-27,11631969,303716048,0,454100,3818981,307535029
2021-08-30,19671443,302476757,0,454100,3728161,306204918
2021-08-31,14543790,291869856,10000,463800,3719676,295589532
2021-09-01,25432872,296586318,30000,483800,3942970,300529288
2021-09-02,43300500,308556794,40900,494700,4229685,312786479
2021-09-03,59211234,318828040,10000,474700,4082420,322910460
2021-09-06,45817825,324735469,50000,504700,4340420,329075889
2021-09-07,40685232,336259787,20000,514700,4395538,340655325
2021-09-08,87079925,377721748,0,494700,4645233,382366981
2021-09-09,108305093,385408588,30200,524900,4939309,390347897
2021-09-10,47122290,352655425,0,494700,4536399,357191824
2021-09-13,49850015,364062214,20000,514700,4740387,368802601
2021-09-14,48841479,364035605,10000,504700,4587723,368623328
2021-09-15,40115821,364139692,10000,514700,4694064,368833756
2021-09-16,29122915,356042829,0,504700,4345467,360388296
2021-09-17,29739059,349189577,20000,502100,4413459,353603036
2021-09-22,64332584,361605189,0,492100,4610977,366216166
2021-09-23,48585603,361140595,0,482100,4387110,365527705
2021-09-24,72042691,374968351,20000,502100,4714719,379683070
2021-09-27,79492843,382578384,400,432500,4186600,386764984
2021-09-28,108399797,378902031,50000,482500,4911850,383813881
2021-09-29,64328588,375592472,0,472200,4452846,380045318
2021-09-30,45796784,364622728,10000,482200,4609832,369232560
2021-10-08,41139908,365898100,0,472000,4299920,370198020
2021-10-11,24135214,348328848,10000,462000,4028640,352357488
2021-10-12,18008384,345520652,0,462000,4047120,349567772
2021-10-13,18023535,332285260,0,461100,3790242,336075502
2021-10-14,24366773,337004813,0,461100,3799464,340804277
2021-10-15,10528966,320074557,0,451100,3649399,323723956
2021-10-18,12585472,315595492,0,451100,3730597,319326089
2021-10-19,17908789,322430638,30000,481100,3997941,326428579
2021-10-20,19574403,319830290,0,451100,3811795,323642085
2021-10-21,13014952,312821477,0,451100,3685487,316506964
2021-10-22,7120760,305879164,0,451100,3617822,309496986
2021-10-25,7569470,304963742,0,451100,3658421,308622163
2021-10-26,10235413,302414644,0,451100,3644888,306059532
2021-10-27,10308753,291627894,30000,481100,3882477,295510371
2021-10-28,29994481,299427101,0,461100,3854796,303281897
2021-10-29,10737912,293716028,0,461100,3721077,297437105
2021-11-01,11860962,291673075,0,461100,3651912,295324987
2021-11-02,14233970,276299712,0,451100,3356184,279655896
2021-11-03,10074740,276090455,0,451100,3333629,279424084
2021-11-04,12322706,279218401,30000,481100,3579384,282797785
2021-11-05,9891829,272802979,0,461100,3255366,276058345
2021-11-08,6216343,270831514,20000,471100,3330677,274162191
2021-11-09,48936628,287153100,10000,461100,3587358,290740458
2021-11-10,37391131,280808350,20000,481100,3795879,284604229
2021-11-11,24101842,286872735,0,461100,3490527,290363262
2021-11-12,11605028,285477761,0,461100,3449028,288926789
2021-11-15,10543280,281304656,0,461100,3472083,284776739
2021-11-16,9276507,279441036,22000,483100,3531461,282972497
2021-11-17,6881316,275530655,0,473100,3472554,279003209
2021-11-18,5594889,273940262,0,473100,3463092,277403354
2021-11-19,12152028,270870484,0,473100,3486747,274357231
2021-11-22,6115089,266191040,0,473100,3496209,269687249
2021-11-23,9009010,267108312,0,473100,3496209,270604521
2021-11-24,19317464,271743498,20000,493100,3698250,275441748
2021-11-25,15991660,268322360,0,493100,3713043,272035403
2021-11-26,8302309,268154602,0,473100,3486747,271641349
2021-11-29,9137176,265882085,0,473100,3491478,269373563
2021-11-30,9092811,267349902,11800,484900,3549468,270899370
2021-12-01,8125752,263044862,8200,493100,3673595,266718457
2021-12-02,11350370,263894194,0,473100,3477285,267371479
2021-12-03,19058674,258915023,30000,503100,3798405,262713428
2021-12-06,13064917,253552673,0,483100,3618419,257171092
2021-12-07,41783514,271350061,22100,505200,3940560,275290621
2021-12-08,15349652,265603474,0,475200,3687552,269291026
2021-12-09,12805801,261522000,20000,495200,3827896,265349896
2021-12-10,11043150,261481450,0,475200,3644784,265126234
2021-12-13,14681600,260060043,20000,495200,3842752,263902795
2021-12-14,15732685,262827732,0,475200,3720816,266548548
2021-12-15,46998437,281579815,76200,551400,4449798,286029613
2021-12-16,26144576,279533670,0,490100,3945305,283478975
2021-12-17,54566350,292138476,59200,549300,4515246,296653722
2021-12-20,25940795,289003500,2000,492100,3853143,292856643
2021-12-21,14144175,294210027,39200,531300,4149453,298359480
2021-12-22,27367383,297579061,0,531300,4048506,301627567
2021-12-23,36419893,309442593,20000,512100,3979017,313421610
2021-12-24,20566291,304608859,0,492100,3730118,308338977
2021-12-27,11874435,301364157,20000,512100,3845871,305210028
2021-12-28,7786228,292753098,0,492100,3621856,296374954
2021-12-29,8018865,283878888,0,492100,3587409,287466297
2021-12-30,11192345,285134482,20000,510100,3718629,288853111
2021-12-31,14087072,288226521,0,490100,3592433,291818954
2022-01-04,9282216,282075483,0,490100,3616938,285692421
2022-01-05,10732926,278151495,0,450100,3240720,281392215
2022-01-06,8332479,279883864,79200,529300,3885062,283768926
2022-01-07,7386548,278555413,0,490100,3523819,282079232
2022-01-10,6530678,273358555,0,490100,3469908,276828463
2022-01-11,7395116,273933860,0,490100,3479710,277413570
2022-01-12,6581244,272512704,0,470100,3351813,275864517
