日期,融资买入额(元),融资余额(元),融券卖出量,融券余量,融券余额(元),融资融券余额(元)
2017-07-12,18205685,495121296,0,11655,253613,495374909
2017-07-13,13551896,498830854,9300,20955,450533,499281387
2017-07-14,14419443,498143731,0,11655,250116,498393847
2017-07-17,21378510,485928224,9500,21155,408503,486336727
2017-07-18,8924050,481278242,0,11355,223466,481501708
2017-07-19,14754708,481937641,9600,20955,415328,482352969
2017-07-20,20019608,475208192,200,11555,235838,475444030
2017-07-21,19472211,469740297,9700,21255,453369,470193666
2017-07-24,9569963,469169698,0,11955,254642,469424340
2017-07-25,21388929,480381703,9300,21255,441679,480823382
2017-07-26,8121007,477142894,0,11655,242541,477385435
2017-07-27,24902666,482845681,0,11655,251748,483097429
2017-07-28,51963401,494890912,9283,20938,460427,495351339
2017-07-31,15161661,492967558,0,11677,252807,493220365
2017-08-01,17476185,498791407,9400,21077,455052,499246459
2017-08-02,11973995,493174407,0,11777,246022,493420429
2017-08-03,15015345,491876066,9500,21277,449370,492325436
2017-08-04,12232961,488317763,0,11977,245888,488563651
2017-08-07,7803100,482349647,8600,20400,421464,482771111
2017-08-08,11539457,479166357,900,12700,266319,479432676
2017-08-09,5865819,474495888,8600,20400,425952,474921840
2017-08-10,18109466,458220504,900,12100,245025,458465529
2017-08-11,8064628,457997570,9000,20200,400364,458397934
2017-08-14,12206085,458710366,200,11800,242372,458952738
2017-08-15,9532606,457611287,2200,14000,287560,457898847
2017-08-16,27928923,464235388,100,11900,251685,464487073
2017-08-17,36517201,473791029,9400,21200,463008,474254037
2017-08-18,22898192,474715174,100,11900,255255,474970429
2017-08-21,36589620,470662828,9400,21200,475516,471138344
2017-08-22,16720812,464837751,100,11900,261681,465099432
2017-08-23,20614716,469704691,9397,20097,431684,470136375
2017-08-24,13038169,471433958,0,10697,228916,471662874
2017-08-25,19761053,476278246,0,297,6475,476284721
2017-08-28,26889487,480595296,19490,19787,437293,481032589
2017-08-29,18553044,477883013,0,10387,224567,478107580
2017-08-30,46396765,480643784,9400,19787,446790,481090574
2017-08-31,27122724,486108406,0,10387,235369,486343775
2017-09-01,20306096,473913288,9400,19787,449759,474363047
2017-09-04,34807237,472502022,0,10387,240978,472743000
2017-09-05,34656018,473181601,9400,19787,453320,473634921
2017-09-06,26401763,470773097,1300,1687,38548,470811645
2017-09-07,26931624,472728567,9400,11087,250123,472978690
2017-09-08,19834158,478276654,100,1736,39529,478316183
2017-09-11,23562882,484401752,19400,21136,484648,484886400
2017-09-12,22116178,478525924,0,11736,264060,478789984
2017-09-13,11759241,471856466,9400,11136,250560,472107026
2017-09-14,20629048,474608650,0,1736,38279,474646929
2017-09-15,13440376,472883779,9400,11136,247108,473130887
2017-09-18,12630126,471485018,0,1736,38643,471523661
2017-09-19,15834597,471717198,9400,11136,242653,471959851
2017-09-20,17020888,469143970,100,1836,40704,469184674
2017-09-21,14570636,461993863,19400,21236,465068,462458931
2017-09-22,14374143,460883182,0,11836,255894,461139076
2017-09-25,10370714,455097290,9400,21236,446168,455543458
2017-09-26,8033172,455662369,0,10536,223258,455885627
2017-09-27,6676654,453246441,0,10536,225470,453471911
2017-09-28,10045701,452044777,4700,15236,322241,452367018
2017-09-29,8173634,443367255,0,10536,223995,443591250
2017-10-09,18699726,441351047,9400,19936,433409,441784456
2017-10-10,25124428,447902658,0,10536,232846,448135504
2017-10-11,16786819,447913773,9400,19936,437795,448351568
2017-10-12,13884029,448837591,0,10536,228842,449066433
2017-10-13,10381149,445383744,9400,19936,438592,445822336
2017-10-16,19020397,446887061,700,20636,432943,447320004
2017-10-17,7611839,442632879,400,10636,221761,442854640
2017-10-18,9016313,441152324,9600,20236,414838,441567162
2017-10-19,7334344,436891661,800,11036,222375,437114036
2017-10-20,8214509,439097490,3500,14436,294639,439392129
2017-10-23,8370530,442296721,0,10936,224407,442521128
2017-10-24,5509134,440762350,9700,20636,419736,441182086
2017-10-25,8022936,442641326,0,10936,224407,442865733
2017-10-26,17041864,436635676,10300,10636,225590,436861266
2017-10-27,11857675,433703308,100,8836,183435,433886743
2017-10-30,9375239,426000641,1000,1236,24535,426025176
2017-10-31,3992660,426500926,8400,8636,172029,426672955
2017-11-01,6438786,426764596,1500,2236,44608,426809204
2017-11-02,5154837,424275454,7900,8636,170302,424445756
2017-11-03,5014599,425997024,2000,2736,53571,426050595
2017-11-06,5890784,428904519,10200,10400,206752,429111271
2017-11-07,7995971,425473889,3300,13700,275781,425749670
2017-11-08,6974773,425401800,0,200,4022,425405822
2017-11-09,4577303,423993876,3500,3700,75073,424068949
2017-11-10,16352913,425308258,0,200,4134,425312392
2017-11-13,11200895,427708915,10000,10200,205326,427914241
2017-11-14,14714955,427906969,0,10200,202572,428109541
2017-11-15,9191057,428001378,0,10200,200736,428202114
2017-11-16,6104332,428602771,0,10200,200532,428803303
2017-11-17,10519400,416383716,700,10900,197399,416581115
2017-11-20,5516206,410728392,0,10900,194238,410922630
2017-11-21,6089982,412236726,800,11700,207558,412444284
2017-11-22,4224048,412840379,0,11700,207324,413047703
2017-11-23,6029982,412442045,2000,3700,63418,412505463
2017-11-24,3537686,411994309,0,3700,63492,412057801
2017-11-27,3647728,411682993,0,3700,63233,411746226
2017-11-28,5865175,412206364,0,3000,52440,412258804
2017-11-29,5082824,410343000,0,2200,38038,410381038
2017-11-30,4241320,409348074,1000,3200,54944,409403018
2017-12-01,5668784,411052469,0,2200,38236,411090705
2017-12-04,6091705,409797296,600,2800,47236,409844532
2017-12-05,12074117,408023295,0,2800,44380,408067675
2017-12-06,6986041,406688076,1000,3200,51904,406739980
2017-12-07,4747195,401257413,0,2200,35750,401293163
2017-12-08,5611783,402338413,0,2200,35926,402374339
2017-12-11,6805497,403301193,1000,3200,53280,403354473
2017-12-12,2546072,400966574,0,3200,52192,401018766
2017-12-13,4630219,401452151,0,3200,52512,401504663
2017-12-14,4128786,397447398,0,2200,36718,397484116
2017-12-15,10393776,399373710,0,2200,36278,399409988
2017-12-18,6568097,398402552,0,2200,35640,398438192
2017-12-19,7058189,399496336,0,2200,35772,399532108
2017-12-20,5053995,397169762,1600,3800,59850,397229612
2017-12-21,5668004,397943644,0,3800,59546,398003190
2017-12-22,3020216,396146222,0,3800,59698,396205920
2017-12-25,5068145,393534207,0,3800,57418,393591625
2017-12-26,7896024,394930976,0,3800,58140,394989116
2017-12-27,4830653,391592254,0,3800,57532,391649786
2017-12-28,4764807,390441548,0,800,12200,390453748
2017-12-29,3744736,384542075,0,800,13424,384555499
2018-01-02,25068373,373261392,1000,1800,31446,373292838
2018-01-03,26010881,385459873,0,800,13800,385473673
2018-01-04,19517211,388174950,6500,7300,124100,388299050
2018-01-05,16604560,388436388,10000,17300,296868,388733256
2018-01-08,11798766,388698205,600,1800,30654,388728859
2018-01-09,11824011,384542553,20000,21400,365084,384907637
2018-01-10,10905372,387333451,400,1800,30258,387363709
2018-01-11,9686532,387276084,0,1400,23618,387299702
2018-01-12,10116189,388241136,0,800,13520,388254656
2018-01-15,12552292,389627469,3300,4100,65190,389692659
2018-01-16,5250926,387623857,0,4100,65559,387689416
2018-01-17,9560320,383994425,400,4500,72900,384067325
2018-01-18,5746931,385966455,0,1000,16370,385982825
2018-01-19,6963331,385260067,100,900,14373,385274440
2018-01-22,18904336,385441592,20900,21700,364126,385805718
2018-01-23,9563500,386409371,0,20800,348816,386758187
2018-01-24,15148313,388322810,0,20800,351520,388674330
2018-01-25,12196092,382753500,0,20800,343200,383096700
2018-01-26,6441979,379919705,0,20800,343200,380262905
2018-01-29,10246116,383383899,0,20800,332592,383716491
2018-01-30,4607062,383419596,0,200,3174,383422770
2018-01-31,5898417,382202469,18500,18700,284988,382487457
2018-02-01,5809710,375692958,1000,1200,16584,375709542
2018-02-02,4829638,370164729,600,1100,14938,370179667
2018-02-05,2965783,365439294,500,700,9450,365448744
2018-02-06,6518322,356421115,21100,21300,258795,356679910
2018-02-07,9441125,358440807,500,700,8652,358449459
2018-02-08,2887976,355678107,1100,1300,16601,355694708
2018-02-09,4663724,352565202,2800,4100,50635,352615837
2018-02-12,5709296,352889286,400,600,7638,352896924
2018-02-13,3074468,350500267,1000,1600,20256,350520523
2018-02-14,3116959,347882743,200,400,5072,347887815
2018-02-22,4334362,348304303,0,200,2582,348306885
2018-02-23,4983472,348015892,0,200,2604,348018496
2018-02-26,5501622,346419412,0,0,0,346419412
2018-02-27,16476965,353505891,0,0,0,353505891
2018-02-28,10645545,351795860,0,0,0,351795860
2018-03-01,32488035,347410435,1800,1800,27252,347437687
2018-03-02,22612266,352944045,0,1800,26118,352970163
2018-03-05,14223875,354331285,4000,5800,84796,354416081
2018-03-06,14774756,355039756,0,4000,58000,355097756
2018-03-07,13580476,353935151,1500,5500,78320,354013471
2018-03-08,12818597,353035364,0,5500,79585,353114949
2018-03-09,22974256,356459417,23900,29400,436590,356896007
2018-03-12,47155010,356750407,16400,31900,504658,357255065
2018-03-13,27723528,367918849,0,31600,485376,368404225
2018-03-14,10636780,367568495,0,5500,83765,367652260
2018-03-15,16647334,362464965,18400,23900,362085,362827050
2018-03-16,28231317,365571011,20000,33900,525111,366096122
2018-03-19,20381573,369423710,0,20500,317955,369741665
2018-03-20,13790220,366666274,0,20500,311395,366977669
2018-03-21,15582216,367757571,0,20500,310780,368068351
2018-03-22,11734108,367596265,30000,40500,613575,368209840
2018-03-23,17894138,362292002,25000,35500,484220,362776222
2018-03-26,9952262,364176047,0,24000,331920,364507967
2018-03-27,14562274,361055076,0,24000,345360,361400436
2018-03-28,22266704,370162043,13700,37700,545896,370707939
2018-03-29,25033248,373476657,38100,75800,1207494,374684151
2018-03-30,64388142,357831076,0,15800,266072,358097148
2018-04-02,50203154,361942517,0,11800,197060,362139577
2018-04-03,28734863,358034881,40500,51900,830919,358865800
2018-04-04,23963277,356769698,0,46900,736330,357506028
2018-04-09,30025949,367409728,400,41100,657600,368067328
2018-04-10,19581803,367630375,0,30800,489412,368119787
2018-04-11,18100019,364938552,10000,40600,647570,365586122
2018-04-12,15475470,363983375,0,40600,635796,364619171
2018-04-13,15335195,363550090,600,40800,638928,364189018
2018-04-16,22951382,366493861,10000,40200,644406,367138267
2018-04-17,22413779,365676639,11200,51400,774084,366450723
2018-04-18,23767287,368468541,10100,60300,937665,369406206
2018-04-19,15481072,363473235,0,60300,938268,364411503
2018-04-20,15423687,360096261,1200,61500,918195,361014456
2018-04-23,11060650,358790615,0,41314,619297,359409912
2018-04-24,19635534,365410034,0,41314,649456,366059490
2018-04-25,24136958,368415804,39886,71200,1146320,369562124
2018-04-26,28441516,368906980,0,31300,507373,369414353
2018-04-27,16898232,366250395,0,31300,497670,366748065
2018-05-02,13900467,364785690,20000,51300,787455,365573145
2018-05-03,22250775,363376197,5500,56800,959352,364335549
2018-05-04,57453912,349734098,15000,51800,875938,350610036
2018-05-07,44197288,363782504,7000,58800,993720,364776224
2018-05-08,73348986,383403168,25000,68800,1212256,384615424
2018-05-09,34056193,383749377,5000,73800,1302570,385051947
2018-05-10,29189354,382323178,0,43800,748542,383071720
2018-05-11,23150846,385967287,0,43800,747666,386714953
2018-05-14,31459176,384186617,40000,83800,1455606,385642223
2018-05-15,19269261,380299753,0,43800,770442,381070195
2018-05-16,15062412,376278506,0,43800,748104,377026610
2018-05-17,15395721,373272982,5000,48800,819352,374092334
2018-05-18,12513624,376130557,35000,83800,1417896,377548453
2018-05-21,21988349,383724027,0,53800,914600,384638627
2018-05-22,25967710,381209833,33700,77500,1355475,382565308
2018-05-23,19696136,378782106,0,52400,904424,379686530
2018-05-24,25714181,377603371,24600,77000,1335180,378938551
2018-05-25,40299301,391977490,15400,67800,1201416,393178906
2018-05-28,55695263,396620420,24600,77000,1419880,398040300
2018-05-29,30803822,391429497,0,77000,1390620,392820117
2018-05-30,27389222,372351167,15400,73400,1192750,373543917
2018-05-31,19543540,372810140,0,73400,1197888,374008028
2018-06-01,15038189,366597448,19000,71400,1101702,367699150
2018-06-04,10223245,359032984,0,56900,863742,359896726
2018-06-05,15117250,359806679,500,57400,889700,360696379
2018-06-06,11966602,361790656,0,57400,898310,362688966
2018-06-07,14917683,356879753,0,57400,912660,357792413
2018-06-08,12866667,356610231,25000,67400,1034590,357644821
2018-06-11,19242457,357693760,10000,67400,1087162,358780922
2018-06-12,25782944,355230881,25000,77400,1280196,356511077
2018-06-13,23530701,360132332,0,67400,1072334,361204666
2018-06-14,19901233,360625678,0,67400,1089184,361714862
2018-06-15,16237458,359318664,3800,71200,1101464,360420128
2018-06-19,13373813,348005088,21200,74600,1038432,349043520
2018-06-20,9334105,345635872,1800,67400,924728,346560600
2018-06-21,7448458,338360627,10000,62400,798720,339159347
2018-06-22,5155392,336903894,47000,108500,1417010,338320904
2018-06-25,4078725,334579785,900,89400,1163094,335742879
2018-06-26,10590000,338817838,0,71500,953810,339771648
2018-06-27,7386820,339026556,0,71500,946660,339973216
2018-06-28,5760247,339307658,0,71500,933075,340240733
2018-06-29,11707826,340444696,0,61500,835170,341279866
2018-07-02,8900970,331781570,800,62300,825475,332607045
2018-07-03,11883145,336395281,40000,102300,1385142,337780423
2018-07-04,6023265,333311555,0,82300,1081422,334392977
2018-07-05,5329414,329981470,0,63700,787332,330768802
2018-07-06,6114224,329725906,19500,71500,918060,330643966
2018-07-09,7440728,329475015,32300,84300,1111074,330586089
2018-07-10,7987034,330007376,15400,79200,1055736,331063112
2018-07-11,5189838,326139056,0,69900,901710,327040766
2018-07-12,9842915,328484384,27100,87700,1166410,329650794
2018-07-13,8978690,329452677,0,77700,1052835,330505512
2018-07-16,8961066,332014468,800,78500,1058965,333073433
2018-07-17,5989884,330099793,0,78500,1056610,331156403
2018-07-18,7636648,330802290,29700,91100,1206164,332008454
2018-07-19,4057707,326978999,0,91100,1189766,328168765
2018-07-20,5443365,324532486,17900,88200,1186290,325718776
2018-07-23,10488036,326452784,0,81400,1114366,327567150
2018-07-24,14016621,329570805,400,61400,846706,330417511
2018-07-25,12554460,332227487,0,61400,843636,333071123
2018-07-26,9164734,330823689,0,61000,839360,331663049
2018-07-27,8233813,329765125,700,61700,832950,330598075
2018-07-30,5699849,326929152,0,51700,688127,327617279
2018-07-31,4155202,328596710,0,40600,539980,329136690
2018-08-01,7533107,326626480,1800,42400,553320,327179800
2018-08-02,6906456,324470411,100,42500,538900,325009311
2018-08-03,4320527,326419685,0,42500,536350,326956035
2018-08-06,4858072,316853166,14600,57100,681774,317534940
2018-08-07,4359808,316614401,0,55300,682402,317296803
2018-08-08,3345165,316539169,0,55300,680743,317219912
2018-08-09,8569068,319751508,0,55300,695121,320446629
2018-08-10,4202232,319398803,0,55300,699545,320098348
2018-08-13,6303452,319744732,0,55300,710605,320455337
2018-08-14,3548925,318783672,0,55300,702310,319485982
2018-08-15,4294211,314185439,0,55300,680190,314865629
2018-08-16,3222324,311483231,900,56200,702500,312185731
2018-08-17,9625992,309036664,16799,72099,922146,309958810
2018-08-20,7274110,309950651,1800,71899,912398,310863049
2018-08-21,12306883,312381509,0,40499,533777,312915286
2018-08-22,8002299,314040603,0,40499,518792,314559395
2018-08-23,10422835,316446250,1300,41799,536699,316982949
2018-08-24,6787107,313392214,0,41799,524159,313916373
2018-08-27,10584195,315626764,20000,61799,793499,316420263
2018-08-28,6515544,313408884,0,59999,776987,314185871
2018-08-29,6066482,311188105,0,59999,775787,311963892
2018-08-30,5853721,306024085,1500,61499,759513,306783598
2018-08-31,4083376,304548792,300,38999,481638,305030430
2018-09-03,5770758,303060870,1500,30199,371750,303432620
2018-09-04,4701046,302181166,0,28699,358738,302539904
2018-09-05,3468337,300285452,0,28699,348980,300634432
2018-09-06,4391488,300647644,0,28699,348693,300996337
2018-09-07,4711136,301068083,11800,40499,493278,301561361
2018-09-10,4116488,299563047,0,38699,457035,300020082
2018-09-11,3739688,301315077,1800,40499,480723,301795800
2018-09-12,3608485,302076208,0,38699,464388,302540596
2018-09-13,3175995,302398841,0,38699,472515,302871356
2018-09-14,2972059,300296166,0,38699,460518,300756684
2018-09-17,2674776,296844893,0,28600,318032,297162925
2018-09-18,3918289,293514505,0,28600,329186,293843691
2018-09-19,4063527,290445416,0,28600,334906,290780322
2018-09-20,2035597,288731841,0,28600,333762,289065603
2018-09-21,3636644,287828456,1000,9600,115008,287943464
2018-09-25,2741414,287250390,0,9600,115008,287365398
2018-09-26,3208203,286264771,0,9600,113760,286378531
2018-09-27,3813498,283673812,800,10400,119496,283793308
2018-09-28,4427836,284044175,0,10400,122928,284167103
2018-10-08,6297835,283773105,0,10400,113048,283886153
2018-10-09,3844254,284231755,0,10400,113984,284345739
2018-10-10,1445248,282791640,0,10400,114712,282906352
2018-10-11,3772225,267340797,10000,20400,202572,267543369
2018-10-12,6710093,262030968,0,10400,97552,262128520
2018-10-15,3428513,260432693,0,10400,95680,260528373
2018-10-16,3647260,258457588,0,10400,95784,258553372
2018-10-17,4997546,258481603,0,9600,90912,258572515
2018-10-18,4226207,256591300,0,8600,78174,256669474
2018-10-19,3208985,254630563,0,8600,80668,254711231
2018-10-22,8589633,257314392,0,8600,84280,257398672
2018-10-23,4394382,255315630,0,8600,82302,255397932
2018-10-24,3402226,253256918,0,8600,83162,253340080
2018-10-25,4078260,252042003,0,8600,82560,252124563
2018-10-26,2841956,250475581,0,8600,82474,250558055
2018-10-29,2273837,250942005,0,8600,81356,251023361
2018-10-30,3420300,250139612,0,8600,82904,250222516
2018-10-31,7253137,251964907,0,8600,83334,252048241
2018-11-01,9235287,252235285,0,8600,84968,252320253
2018-11-02,12282490,254772389,0,8600,88064,254860453
2018-11-05,9457669,252007378,0,8600,88580,252095958
2018-11-06,6239077,253173383,1000,9600,98688,253272071
2018-11-07,7144946,253685330,0,8600,87720,253773050
2018-11-08,5403463,252089586,0,8600,86172,252175758
2018-11-09,5312426,250220886,0,8600,86946,250307832
2018-11-12,9668239,250697255,3000,11600,122032,250819287
2018-11-13,18207317,257985802,24800,33400,358382,258344184
2018-11-14,11802769,255149935,3000,33372,354411,255504346
2018-11-15,16022499,260398720,3000,33372,365090,260763810
2018-11-16,18876381,264171364,2980,33352,370207,264541571
2018-11-19,14864178,261270254,3000,4052,45382,261315636
2018-11-20,14958041,263183720,4500,4480,48742,263232462
2018-11-21,10305988,264343748,7200,7165,78099,264421847
2018-11-22,9620218,260400652,3000,7165,78385,260479037
2018-11-23,10936444,256406340,4100,6065,61742,256468082
2018-11-26,4824117,248066609,21700,24765,259042,248325651
2018-11-27,13089236,245317232,3000,23565,254031,245571263
2018-11-28,23049606,240840277,14200,32865,376304,241216581
2018-11-29,21864952,230353483,2972,21637,232598,230586081
2018-11-30,8574896,222485148,3000,3000,31710,222516858
2018-12-03,20024474,228890793,10000,10000,110100,229000893
2018-12-04,10389191,229871701,0,5000,55750,229927451
2018-12-05,8198917,229982193,0,0,0,229982193
2018-12-06,6614595,228584701,0,0,0,228584701
2018-12-07,4251749,223959665,0,0,0,223959665
2018-12-10,9931602,223342649,7900,7900,84056,223426705
2018-12-11,4608213,222462186,0,7900,85320,222547506
2018-12-12,6268202,224965129,5000,12900,138417,225103546
2018-12-13,13235336,224350414,3000,15900,170130,224520544
2018-12-14,5642713,223211990,0,15900,163929,223375919
2018-12-17,3624818,223445131,2000,17900,185265,223630396
2018-12-18,4724667,223707547,2400,10400,107224,223814771
2018-12-19,4462677,223692655,0,10400,105040,223797695
2018-12-20,5870241,226762398,0,10400,105560,226867958
2018-12-21,3346807,226230777,0,10400,105144,226335921
2018-12-24,5499422,223750521,0,10400,106392,223856913
2018-12-25,7207056,222578687,2900,13300,132734,222711421
2018-12-26,3085637,221681868,0,5300,53000,221734868
2018-12-27,3084998,220561057,0,5300,51781,220612838
2018-12-28,2293626,219706085,2000,7300,71102,219777187
2019-01-02,1705694,219134129,500,7800,76440,219210569
2019-01-03,5500587,219994056,1100,8900,87398,220081454
2019-01-04,8237554,220422955,0,5300,53530,220476485
2019-01-07,9218873,222553199,0,5300,54431,222607630
2019-01-08,11794922,224607317,0,4800,49632,224656949
2019-01-09,8587505,219517632,0,4800,49920,219567552
2019-01-10,9171031,222319661,0,4800,50256,222369917
2019-01-11,8349361,221839651,400,5200,55016,221894667
2019-01-14,8297353,222252414,0,5200,54912,222307326
2019-01-15,15787294,227628328,0,5200,56472,227684800
2019-01-16,9062019,226689094,0,5200,55172,226744266
2019-01-17,3637828,223241547,0,5200,54756,223296303
2019-01-18,5243712,219723223,0,5200,54496,219777719
2019-01-21,4021203,219007589,0,5200,54444,219062033
2019-01-22,4357052,216999777,0,5200,53352,217053129
2019-01-23,3089795,217453694,0,5200,53820,217507514
2019-01-24,9170286,219696373,0,5200,54912,219751285
2019-01-25,5728363,217846775,0,5200,53716,217900491
2019-01-28,4368668,217557457,0,5200,52988,217610445
2019-01-29,4975239,217085133,0,4800,47568,217132701
2019-01-30,2112444,215306241,0,4800,46800,215353041
2019-01-31,5797252,215204572,0,4800,45024,215249596
2019-02-01,3514105,215302662,0,4800,46176,215348838
2019-02-11,4890591,217449406,0,4800,47520,217496926
2019-02-12,7094287,217224988,0,4800,48528,217273516
2019-02-13,29697190,224686527,0,4800,53376,224739903
2019-02-14,34647274,213518548,0,4800,57120,213575668
2019-02-15,21511417,213680968,0,4800,56064,213737032
2019-02-18,44661039,231013832,0,4800,56736,231070568
2019-02-19,25832012,228429089,0,4800,55632,228484721
2019-02-20,22208693,234610205,0,4800,55008,234665213
2019-02-21,25092538,234671090,0,4800,54528,234725618
2019-02-22,25845697,236034316,0,4800,55872,236090188
2019-02-25,41947483,239780854,0,4800,58608,239839462
2019-02-26,27410224,240422904,0,4800,57648,240480552
2019-02-27,37453851,254636755,0,4800,57072,254693827
2019-02-28,16081934,258561776,0,4800,57888,258619664
2019-03-01,15693635,249307746,0,4800,57408,249365154
2019-03-04,41513508,251607975,0,4800,61200,251669175
2019-03-05,35146606,257005429,0,4800,61200,257066629
2019-03-06,45894681,265894907,0,4800,62112,265957019
2019-03-07,61419930,278698583,0,4800,64128,278762711
2019-03-08,47094452,266910121,0,4800,60816,266970937
2019-03-11,37552821,277411966,0,4800,64176,277476142
2019-03-12,49060570,284781370,0,4800,66288,284847658
2019-03-13,32857987,283250519,0,4800,63120,283313639
2019-03-14,21596157,281487321,0,4800,60720,281548041
2019-03-15,18266260,286566332,0,4800,61584,286627916
2019-03-18,18618103,292183495,0,4800,62592,292246087
2019-03-19,23745599,294229933,0,4800,62880,294292813
2019-03-20,16988316,289981499,0,4800,62304,290043803
2019-03-21,25524223,294546616,0,4800,63216,294609832
2019-03-22,16911350,291802960,0,4800,63408,291866368
2019-03-25,17671415,288911631,0,4800,61440,288973071
2019-03-26,13629665,279343708,0,4800,59568,279403276
2019-03-27,13614956,279997398,0,4800,59088,280056486
2019-03-28,7962144,277914684,0,4800,58272,277972956
2019-03-29,12876526,277862061,0,4800,60384,277922445
2019-04-01,22206346,282341185,0,2400,31344,282372529
2019-04-02,14743585,278932457,2000,4400,57904,278990361
2019-04-03,24901574,287633654,0,4400,58916,287692570
2019-04-04,20253973,287213313,400,3800,50426,287263739
2019-04-08,21609580,289580665,300,4100,52972,289633637
2019-04-09,22366273,287182307,200,4300,57577,287239884
2019-04-10,20906568,294801932,0,3300,43329,294845261
2019-04-11,15699244,292112947,0,2400,30720,292143667
2019-04-12,7409969,288248293,0,1400,17822,288266115
2019-04-15,22289372,262468953,1900,3300,43461,262512414
2019-04-16,32684962,268326518,0,3300,44979,268371497
2019-04-17,50087551,276205290,0,3300,46530,276251820
2019-04-18,23077851,273017913,0,3300,45243,273063156
2019-04-19,17874877,270484602,0,3300,44847,270529449
2019-04-22,16889267,269942003,0,3300,43890,269985893
2019-04-23,10602487,267942514,0,3300,42801,267985315
2019-04-24,14966666,265977802,0,3300,43362,266021164
2019-04-25,14734820,261637411,0,3300,40689,261678100
2019-04-26,11659680,264260973,0,3300,40029,264301002
2019-04-29,8930172,254834664,0,1400,16128,254850792
2019-04-30,7144399,254070038,0,1400,16324,254086362
2019-05-06,10440246,251097574,0,1400,14686,251112260
2019-05-07,6934172,249785745,0,1400,14980,249800725
2019-05-08,8725471,250637096,0,1400,14910,250652006
2019-05-09,3904437,250180253,0,1400,14826,250195079
2019-05-10,14145469,253724397,0,1400,15484,253739881
2019-05-13,7739302,250312454,0,1400,15176,250327630
2019-05-14,4708962,251099274,0,1400,15064,251114338
2019-05-15,5579625,248803121,0,1400,15302,248818423
2019-05-16,5557306,245205859,0,1400,15372,245221231
2019-05-17,8779764,240360336,0,1400,14504,240374840
2019-05-20,6585863,241142828,0,1400,14952,241157780
2019-05-21,5230457,240767691,0,1400,15148,240782839
2019-05-22,6078435,241434257,0,1400,15232,241449489
2019-05-23,4015733,238541075,0,1400,14840,238555915
2019-05-24,2314177,237474425,0,1400,14952,237489377
2019-05-27,6280331,238302612,0,1400,15428,238318040
2019-05-28,7831323,240150574,0,1400,15414,240165988
2019-05-29,3825998,239660939,0,1400,15400,239676339
2019-05-30,4407545,239962422,0,1400,15302,239977724
2019-05-31,4100046,239322702,0,1400,15078,239337780
2019-06-03,2869443,237474845,0,1400,15008,237489853
2019-06-04,3598159,238106936,0,1400,14616,238121552
2019-06-05,1497627,235333275,0,1400,14826,235348101
2019-06-06,2638600,234586307,0,1400,14644,234600951
2019-06-10,3533071,236230037,0,1400,14770,236244807
2019-06-11,10847829,239236889,0,1400,15302,239252191
2019-06-12,7820314,240987567,0,1400,15106,241002673
2019-06-13,8885383,242140595,0,1400,15372,242155967
2019-06-14,5731427,240232133,0,1400,14798,240246931
2019-06-17,2227368,239131993,0,1400,14910,239146903
2019-06-18,3071602,239817466,0,1400,14840,239832306
2019-06-19,6486925,239769018,0,1400,15092,239784110
2019-06-20,12213651,244588740,0,1400,15372,244604112
2019-06-21,9117486,240104620,0,1400,15750,240120370
2019-06-24,7302474,240713756,0,1400,15596,240729352
2019-06-25,6948862,242497892,0,1400,15428,242513320
2019-06-26,3235363,242293874,0,1400,15372,242309246
2019-06-27,7842449,243018405,0,1400,15442,243033847
2019-06-28,5317405,239109256,0,1400,15050,239124306
2019-07-01,7095770,237294939,0,1400,15596,237310535
2019-07-02,3386798,235730261,0,1400,15512,235745773
2019-07-03,4775795,237043584,0,1400,15274,237058858
2019-07-04,3848770,237633413,0,1400,15274,237648687
2019-07-05,2893927,237838655,0,1400,15330,237853985
2019-07-08,10457127,238640196,0,1400,14476,238654672
2019-07-09,6013099,239234646,0,1400,14322,239248968
2019-07-10,2656546,238046276,0,1400,14126,238060402
2019-07-11,3692130,236313165,0,1400,14252,236327417
2019-07-12,2609152,236925395,0,1400,14266,236939661
2019-07-15,4743623,237084804,0,1400,14462,237099266
2019-07-16,2609831,236245102,0,1400,14420,236259522
2019-07-17,4079223,237511094,0,1400,14420,237525514
2019-07-18,2828981,234071190,0,1400,14042,234085232
2019-07-19,4288472,235262578,0,1400,14098,235276676
2019-07-22,3005694,233063683,0,1400,13328,233077011
2019-07-23,1640677,230805116,0,1400,13860,230818976
2019-07-24,2454877,230088480,0,1400,14238,230102718
2019-07-25,2036571,230394027,3800,5200,52624,230446651
2019-07-26,1153743,229553543,0,1400,14154,229567697
2019-07-29,840817,229395251,3800,5200,52364,229447615
2019-07-30,2186160,228136296,0,1400,14154,228150450
2019-07-31,2553018,228006134,3800,5200,51948,228058082
2019-08-01,3646571,228858566,0,1400,13790,228872356
2019-08-02,1915225,227762841,3800,5200,50128,227812969
2019-08-05,1760214,227832799,0,1400,13342,227846141
2019-08-06,4629080,227302065,3800,5200,46644,227348709
2019-08-07,2654842,227793363,0,3600,31824,227825187
2019-08-08,2778739,227573173,1600,3000,27060,227600233
2019-08-09,1258269,225498695,2200,3600,32004,225530699
2019-08-12,2627480,225721080,1600,3000,27150,225748230
2019-08-13,1799918,224391538,2200,3600,32148,224423686
2019-08-14,4031636,225788716,1600,3000,26970,225815686
2019-08-15,4488617,226643520,2200,3600,32616,226676136
2019-08-16,3289656,226079666,1600,3000,27360,226107026
2019-08-19,8492155,225648834,2200,3600,35136,225683970
2019-08-20,7914736,223048654,1600,3000,29580,223078234
2019-08-21,8641267,220479974,2200,3600,36432,220516406
2019-08-22,6789044,222305807,1600,3000,30000,222335807
2019-08-23,4480960,221936867,2200,3600,35208,221972075
2019-08-26,4081806,222502140,1600,3000,29280,222531420
2019-08-27,1732382,220491057,2200,3600,35892,220526949
2019-08-28,2344851,220742732,0,3600,35748,220778480
2019-08-29,3541681,220501989,1600,3000,30030,220532019
2019-08-30,4546741,221118856,2200,3600,34776,221153632
2019-09-02,4278673,220217047,1600,3000,30300,220247347
2019-09-03,6303671,222383209,2200,3600,36504,222419713
2019-09-04,4486286,218899839,1600,3000,30810,218930649
2019-09-05,7883213,218208762,2200,3600,37080,218245842
2019-09-06,6749218,216648227,100,1500,15555,216663782
2019-09-09,6323938,214870321,0,1400,14952,214885273
2019-09-10,3134025,213001981,1900,3300,35211,213037192
2019-09-11,8431253,215861706,0,3300,34386,215896092
2019-09-12,3895852,216213640,1900,3300,34782,216248422
2019-09-16,4115483,215509402,1900,5200,54860,215564262
2019-09-17,3929060,214368380,0,1400,14392,214382772
2019-09-18,2686546,213863545,3800,5200,52936,213916481
2019-09-19,4478443,215776263,0,1400,14378,215790641
2019-09-20,9173768,218453105,0,1400,14560,218467665
2019-09-23,3793579,216637235,3800,5200,52988,216690223
2019-09-24,7545771,215361367,0,5200,53612,215414979
2019-09-25,4213711,214883938,0,1400,14028,214897966
2019-09-26,5399164,211689791,3800,3800,35416,211725207
2019-09-27,3620336,208274666,1400,5200,51116,208325782
2019-09-30,1887288,206569705,0,0,0,206569705
2019-10-08,3048704,208015865,3800,3800,35606,208051471
2019-10-09,3122255,207614525,0,0,0,207614525
2019-10-10,3500806,208461686,4000,4000,39120,208500806
2019-10-11,1829888,207563506,1200,2500,24200,207587706
2019-10-14,2139717,206562541,2600,5100,50439,206612980
2019-10-15,1709383,205305514,0,1300,12636,205318150
2019-10-16,2124150,205961195,3800,5100,48909,206010104
2019-10-17,2458366,205176153,0,1300,12402,205188555
2019-10-18,2972132,205645123,3800,5100,46665,205691788
2019-10-21,2473675,206678721,100,5200,47372,206726093
2019-10-22,1058706,204714185,0,100,931,204715116
2019-10-23,1344457,204411425,1900,1900,17746,204429171
2019-10-24,1598689,204420034,0,0,0,204420034
2019-10-25,1367185,205031151,3800,3800,35682,205066833
2019-10-28,3755773,205574127,0,3800,37050,205611177
2019-10-29,1244614,203712498,1400,5200,50180,203762678
2019-10-30,1203523,202404101,0,1400,13202,202417303
2019-10-31,2107986,202097273,100,1500,14085,202111358
2019-11-01,8439557,202965406,1900,3300,34089,202999495
2019-11-04,22395122,217628129,16300,17700,179124,217807253
2019-11-05,18341316,210565548,1900,17700,184080,210749628
2019-11-06,12812785,211538979,1900,19600,207564,211746543
2019-11-07,10303218,212778880,0,1400,14378,212793258
2019-11-08,27008131,215652106,3800,5200,56368,215708474
2019-11-11,14639467,209053561,0,1400,16688,209070249
2019-11-12,46269876,212621760,31100,32500,396175,213017935
2019-11-13,33446317,213553852,0,30200,357568,213911420
2019-11-14,45222306,218043475,0,29500,370520,218413995
2019-11-15,29321489,213047358,700,30200,341260,213388618
2019-11-18,24179377,217791205,0,29500,325975,218117180
2019-11-19,19903554,206798350,0,29500,337775,207136125
2019-11-20,21041783,206927005,0,29500,338365,207265370
2019-11-21,8481135,199315382,300,25800,288186,199603568
2019-11-22,15496538,194535710,1900,26700,281685,194817395
2019-11-25,8609408,197219616,0,24800,256184,197475800
2019-11-26,9404418,197285129,0,24800,259408,197544537
2019-11-27,11484358,194459680,600,25400,269240,194728920
2019-11-28,14999732,199826052,800,25600,269824,200095876
2019-11-29,8351200,199021172,3800,28600,295152,199316324
2019-12-02,11143751,198388195,500,25300,269445,198657640
2019-12-03,9847359,193994522,0,24800,270072,194264594
2019-12-04,13127282,191474103,3800,28600,323466,191797569
2019-12-05,59055668,225955186,1400,30000,373200,226328386
2019-12-06,67266117,249587842,0,30000,410400,249998242
2019-12-09,35753150,243520133,4000,34000,511700,244031833
2019-12-10,79976702,208042270,0,30200,489542,208531812
2019-12-11,75029241,208001404,3800,33600,490560,208491964
2019-12-12,57771648,231251752,0,29800,425544,231677296
2019-12-13,59216644,233526209,3800,33600,487200,234013409
2019-12-16,62348778,237473136,0,33600,494928,237968064
2019-12-17,53564470,243238490,400,30300,448137,243686627
2019-12-18,94981777,260486436,3700,33900,535959,261022395
2019-12-19,47661568,215969129,100,33600,478128,216447257
2019-12-20,33062932,219093285,0,29800,412432,219505717
2019-12-23,16163274,214372143,3800,33600,462000,214834143
2019-12-24,24501017,216053936,0,33600,465696,216519632
2019-12-25,27169629,226689460,0,29800,415710,227105170
2019-12-26,18229307,218922261,0,29800,407962,219330223
2019-12-27,28293861,216172464,3800,33600,447888,216620352
2019-12-30,20852302,213913801,0,31000,393700,214307501
2019-12-31,8430394,201911102,3000,32800,421480,202332582
2020-01-02,20467847,202888730,1200,31000,416330,203305060
2020-01-03,14755724,194587560,0,31000,410440,194998000
2020-01-06,11357286,191227448,0,5000,66100,191293548
2020-01-07,18524567,196734661,1900,6900,92460,196827121
2020-01-08,11892344,192208319,2300,7300,96287,192304606
2020-01-09,28224576,203218132,24800,31700,431437,203649569
2020-01-10,14885346,199504812,0,31700,422878,199927690
2020-01-13,9957188,199288194,400,5400,72846,199361040
2020-01-14,11446727,196518453,500,5500,71940,196590393
2020-01-15,10353262,197992542,0,5000,65800,198058342
2020-01-16,28917900,198773978,400,1400,19544,198793522
2020-01-17,23477576,196481059,0,1000,13280,196494339
2020-01-20,12571255,193178669,24800,25300,302335,193481004
2020-01-21,7052611,188506609,0,25300,298287,188804896
2020-01-22,10970653,190925581,0,25300,300311,191225892
2020-01-23,6544045,181292432,1900,27200,309808,181602240
2020-02-03,466375,176781633,0,27200,278800,177060433
2020-02-04,8410077,170941739,0,27200,270096,171211835
2020-02-05,5575008,164553691,0,27200,285600,164839291
2020-02-06,12528503,168031147,0,27200,292128,168323275
2020-02-07,7794842,167422043,0,27200,299200,167721243
2020-02-10,6775832,165577275,1900,27200,298928,165876203
2020-02-11,12290046,165106989,5900,31200,346008,165452997
2020-02-12,14255730,172587492,1900,31200,345384,172932876
2020-02-13,8124048,164484045,1900,27200,294576,164778621
2020-02-14,7694133,160759700,0,27200,296480,161056180
2020-02-17,9957165,159585917,500,25800,294378,159880295
2020-02-18,14789184,163045797,4200,30000,354000,163399797
2020-02-19,13329821,160071245,0,1000,11980,160083225
2020-02-20,17277521,165019369,3800,4300,51342,165070711
2020-02-21,23400900,166985111,24800,28200,338964,167324075
2020-02-24,20029255,166214574,900,4100,50922,166265496
2020-02-25,15291806,164756377,1100,1600,19456,164775833
2020-02-26,8133668,158089685,3600,5000,58800,158148485
2020-02-27,7456927,160730285,200,1600,18912,160749197
2020-02-28,4848121,152622463,1900,3300,35211,152657674
2020-03-02,7367152,150216951,1900,3400,39066,150256017
2020-03-03,8421383,151686675,0,2800,32508,151719183
2020-03-04,5523869,151820491,1900,3300,38082,151858573
2020-03-05,6749369,151292182,100,1500,17505,151309687
2020-03-06,12682328,156388682,26700,28100,332985,156721667
2020-03-09,11391450,156803505,1900,3300,36399,156839904
2020-03-10,7594959,158050106,1900,2800,31640,158081746
2020-03-11,8567003,158263046,0,900,10125,158273171
2020-03-12,6593423,160843950,900,1800,19782,160863732
2020-03-13,4412116,159949960,3300,4200,44520,159994480
2020-03-16,2426812,156569447,600,2800,28000,156597447
2020-03-17,5072724,158128878,2400,3300,32670,158161548
2020-03-18,3991715,157954286,600,1900,18278,157972564
2020-03-19,5251804,161140585,0,0,0,161140585
2020-03-20,5847120,162758079,1900,1900,19323,162777402
2020-03-23,3784826,162537528,1900,1900,18506,162556034
2020-03-24,3764367,163154671,1900,1900,19000,163173671
2020-03-25,5377733,163520266,1500,3300,33561,163553827
2020-03-26,3764535,161718647,300,300,3003,161721650
2020-03-27,1928434,156662182,1900,1900,18658,156680840
2020-03-30,3369278,156131311,1800,1800,16902,156148213
2020-03-31,1369096,155841151,3400,3600,33588,155874739
2020-04-01,3083348,156868954,600,600,5652,156874606
2020-04-02,4732633,159927411,3200,3200,30624,159958035
2020-04-03,2438299,157564116,600,600,5634,157569750
2020-04-07,1886159,155133262,0,600,5868,155139130
2020-04-08,2922176,155801428,0,0,0,155801428
2020-04-09,4447438,155734254,3800,3800,37810,155772064
2020-04-10,2125005,154648913,0,0,0,154648913
2020-04-13,2852285,155739215,0,0,0,155739215
2020-04-14,2280831,155353004,3800,3800,36632,155389636
2020-04-15,8070445,156065151,0,3800,37126,156102277
2020-04-16,3937656,155008950,0,0,0,155008950
2020-04-17,10822066,157858639,3800,3800,38266,157896905
2020-04-20,6792790,155311386,4000,4000,40480,155351866
2020-04-21,4700011,155267369,15400,17800,181560,155448929
2020-04-22,4031233,155100658,0,0,0,155100658
2020-04-23,5670005,154652421,3800,3800,38228,154690649
2020-04-24,2502770,153950045,0,3800,37772,153987817
2020-04-27,2918987,155392216,0,3700,36667,155428883
2020-04-28,3067986,154159286,0,200,1932,154161218
2020-04-29,1695314,153031001,1700,1900,18335,153049336
2020-04-30,4650626,153116811,1900,1900,19361,153136172
2020-05-06,7345711,154169981,0,0,0,154169981
2020-05-07,4259426,152322218,3800,3800,40356,152362574
2020-05-08,8698292,154820480,9100,9100,97825,154918305
2020-05-11,9293608,156058784,4000,8000,84960,156143744
2020-05-12,3815817,155285896,400,4400,46508,155332404
2020-05-13,4538750,155559211,1000,3500,36715,155595926
2020-05-14,2059417,153898054,1000,3500,36680,153934734
2020-05-15,8003207,154419834,7600,10100,109383,154529217
2020-05-18,7526004,156828288,2800,5300,54802,156883090
2020-05-19,6543466,155979036,0,2500,26900,156005936
2020-05-20,8968206,154758761,1900,4400,47608,154806369
2020-05-21,25018167,154957607,15000,17500,197750,155155357
2020-05-22,10717416,156498734,0,4500,50130,156548864
2020-05-25,18143904,156457411,21500,26000,303940,156761351
2020-05-26,18619573,157471888,300,9700,113975,157585863
2020-05-27,15857641,157487844,1900,6400,72192,157560036
2020-05-28,17849739,159163656,1900,8300,95865,159259521
2020-05-29,15682381,156860653,17700,22200,265512,157126165
2020-06-01,29311616,160816192,6600,21100,275355,161091547
2020-06-02,25606626,161141756,3800,21800,282964,161424720
2020-06-03,31298112,172002270,0,21800,279694,172281964
2020-06-04,23973294,176991298,30800,52600,698528,177689826
2020-06-05,18763645,177521421,0,52600,673806,178195227
2020-06-08,14842601,179404450,0,47800,598934,180003384
2020-06-09,12429977,174324745,200,46000,564420,174889165
2020-06-10,11228821,177237815,0,34200,421686,177659501
2020-06-11,13930649,183301260,3600,32100,393546,183694806
2020-06-12,7519372,180992119,300,24300,295002,181287121
2020-06-15,12221039,179042509,3800,27800,341940,179384449
2020-06-16,13775119,181102604,4200,32000,412800,181515404
2020-06-17,12398656,181835731,3000,34500,436770,182272501
2020-06-18,8219666,180535577,0,31500,389655,180925232
2020-06-19,13428234,179594798,0,27700,354006,179948804
2020-06-22,13092980,177861734,0,27700,355391,178217125
2020-06-23,7362399,174705615,3800,31500,394695,175100310
2020-06-24,8289544,169944110,0,24000,293760,170237870
2020-06-29,5387372,170275702,17500,41500,507545,170783247
2020-06-30,17934117,179935465,700,42200,567590,180503055
2020-07-01,0,175224223,0,42200,624560,175848783
2020-07-02,74386727,187792522,6700,48900,745725,188538247
2020-07-03,62303344,194237545,0,45100,756778,194994323
2020-07-06,78790055,207465516,3800,48900,836679,208302195
2020-07-07,86784725,234276933,0,45100,823526,235100459
2020-07-08,63497788,238968758,3800,48900,903183,239871941
2020-07-09,57611812,236650693,0,35100,643383,237294076
2020-07-10,35439528,226582553,13800,48900,850371,227432924
2020-07-13,42893136,233802204,0,35100,646893,234449097
2020-07-14,31185833,233236293,9123,42223,754947,233991240
2020-07-15,18738563,223084135,5100,44123,759357,223843492
2020-07-16,16676156,223329593,400,44023,723298,224052891
2020-07-17,14406252,223268566,3500,46623,794922,224063488
2020-07-20,35938561,239800199,0,33223,594027,240394226
2020-07-21,22987499,232141839,8600,41823,719774,232861613
2020-07-22,19677317,226026646,5000,44023,771723,226798369
2020-07-23,17279824,222802724,2800,35923,616079,223418803
2020-07-24,21709522,217694966,11900,45023,758187,218453153
2020-07-27,12911107,215029802,0,43123,668838,215698640
2020-07-28,7827548,210778136,3300,46423,727913,211506049
2020-07-29,9987150,210257456,2000,36023,583573,210841029
2020-07-30,10183475,210567352,2800,37923,616249,211183601
2020-07-31,11526659,212484441,0,30223,492635,212977076
2020-08-03,15109402,214345905,0,30223,511071,214856976
2020-08-04,10656975,211509713,4400,34623,576127,212085840
2020-08-05,9552157,211595784,4200,38823,651838,212247622
2020-08-06,15484806,209572912,3000,24823,418516,209991428
2020-08-07,14833149,208974895,17000,34623,577858,209552753
2020-08-10,11811241,199772654,100,24423,386128,200158782
2020-08-11,9751282,203118494,200,24623,380425,203498919
2020-08-12,5954563,200694746,200,12923,194750,200889496
2020-08-13,10307492,203581814,0,12923,195396,203777210
2020-08-14,6690987,202644555,11500,24423,372695,203017250
2020-08-17,9032487,203864045,100,24523,380597,204244642
2020-08-18,8340293,204197568,1000,25523,395607,204593175
2020-08-19,7369254,200862774,2700,28223,423063,201285837
2020-08-20,2371489,200406360,7200,25723,386617,200792977
2020-08-21,5476836,201964022,0,25723,388417,202352439
2020-08-24,11347140,205715597,2400,16523,255941,205971538
2020-08-25,6549299,204883319,800,17323,269373,205152692
2020-08-26,5706096,203327098,0,16623,246020,203573118
2020-08-27,5399640,202723461,7400,24023,354339,203077800
2020-08-28,4200905,201969093,0,24023,359624,202328717
2020-08-31,6276277,201161935,600,20923,318239,201480174
2020-09-01,4850375,203835321,15200,36123,550515,204385836
2020-09-02,9410423,202124038,3100,39223,602073,202726111
2020-09-03,5018325,199524146,0,23423,349003,199873149
2020-09-04,6605070,200011897,20700,44123,675082,200686979
2020-09-07,6440488,202484811,0,42823,641489,203126300
2020-09-08,3696333,201301539,2000,23123,351470,201653009
2020-09-09,4835307,201276683,0,17823,260750,201537433
2020-09-10,5451325,202192165,900,18323,249010,202441175
2020-09-11,3551212,202148249,100,16823,235522,202383771
2020-09-14,3297649,198526706,3700,20523,296557,198823263
2020-09-15,2010530,196460401,0,20523,294505,196754906
2020-09-16,1661767,193478247,0,20523,287938,193766185
2020-09-17,2635199,194283765,0,20523,290400,194574165
2020-09-18,3084112,192705315,0,20523,292863,192998178
2020-09-21,3169324,192997596,0,20523,289785,193287381
2020-09-22,1013232,190769436,0,20523,285885,191055321
2020-09-23,1220461,191238691,0,20523,286706,191525397
2020-09-24,1240572,191093795,22400,39323,530074,191623869
2020-09-25,4007258,189977856,600,7423,100953,190078809
2020-09-28,6202422,187880620,0,7423,97019,187977639
2020-09-29,3352182,189086571,800,8223,111175,189197746
2020-09-30,1414352,187757716,25200,33423,449874,188207590
2020-10-09,4018260,187416745,100,33523,468652,187885397
2020-10-12,5497366,188789914,0,33523,482731,189272645
2020-10-13,4975640,189249856,0,33523,483066,189732922
2020-10-14,3084205,188185403,100,33623,479128,188664531
2020-10-15,3938733,186000121,300,33923,477975,186478096
2020-10-16,3500049,185991870,0,33923,483742,186475612
2020-10-19,2573950,183803650,0,33923,477975,184281625
2020-10-20,3834343,185584826,0,33923,479671,186064497
2020-10-21,6608715,185779442,0,10423,138834,185918276
2020-10-22,2700267,180729265,0,10423,142587,180871852
2020-10-23,9143648,183188552,14000,24423,345341,183533893
2020-10-26,6662443,184604029,10000,20623,296146,184900175
2020-10-27,3064357,184426533,0,9723,136608,184563141
2020-10-28,4663074,185755234,0,9723,135344,185890578
2020-10-29,4145086,186922574,24400,31123,434477,187357051
2020-10-30,7192277,187457370,0,31123,437901,187895271
2020-11-02,7840274,190191990,0,31123,446926,190638916
2020-11-03,9706356,192826588,3700,34823,506326,193332914
2020-11-04,13280720,193035101,0,34823,531747,193566848
2020-11-05,10637691,196470372,0,31523,482302,196952674
2020-11-06,7789430,198825848,6200,37723,572635,199398483
2020-11-09,17403557,205888883,0,34023,523954,206412837
2020-11-10,8580787,205079165,3700,37723,559055,205638220
2020-11-11,5803569,203377780,0,37723,553396,203931176
2020-11-12,7428631,204359128,0,37723,562827,204921955
2020-11-13,8836967,204896557,0,37723,579425,205475982
2020-11-16,11965745,205594143,0,37723,591119,206185262
2020-11-17,7708758,206404740,0,37723,582443,206987183
2020-11-18,6229556,201955660,0,35023,527096,202482756
2020-11-19,6358779,203358613,0,35023,531299,203889912
2020-11-20,4634448,203385232,600,35623,535057,203920289
2020-11-23,7026083,199871315,0,35623,531139,200402454
2020-11-24,5253197,199129421,0,35623,521521,199650942
2020-11-25,4819229,197125245,0,35623,500859,197626104
2020-11-26,6597923,194996355,0,35623,489460,195485815
2020-11-27,3375488,195178340,0,10423,139668,195318008
2020-11-30,3114005,195727745,0,6723,90626,195818371
2020-12-01,2865748,195971424,0,6723,91567,196062991
2020-12-02,3832632,196514446,0,6723,91500,196605946
2020-12-03,4062679,197079351,0,6723,90895,197170246
2020-12-04,2331949,196859002,0,6723,90290,196949292
2020-12-07,3515918,198982067,3700,10423,141127,199123194
2020-12-08,1037452,196420091,0,10423,141023,196561114
2020-12-09,2435090,193766157,0,10423,136333,193902490
2020-12-10,2177003,191466112,0,8223,105912,191572024
2020-12-11,4293581,182528624,0,8223,101719,182630343
2020-12-14,795432,182429885,0,8223,102870,182532755
2020-12-15,799792,181874629,0,8223,102047,181976676
2020-12-16,934124,180366388,0,8223,98758,180465146
2020-12-17,1851685,180061350,0,4423,54757,180116107
2020-12-18,944636,179673866,0,4423,54314,179728180
2020-12-21,1405856,179409611,0,4423,53961,179463572
2020-12-22,3707000,180398786,0,4423,53164,180451950
2020-12-23,2968552,180744325,0,723,8690,180753015
2020-12-24,2138316,175971441,3700,4423,50909,176022350
2020-12-25,808494,173673344,0,4423,51130,173724474
2020-12-28,2382602,171078730,0,4423,49272,171128002
2020-12-29,2342006,171681041,0,4423,49847,171730888
2020-12-30,907357,171616529,0,4423,49803,171666332
2020-12-31,959748,169947453,0,723,8372,169955825
2021-01-04,18600550,179613973,3700,4423,55155,179669128
2021-01-05,2372650,179261440,0,2623,32420,179293860
2021-01-06,2027815,179210974,0,723,8748,179219722
2021-01-07,2729037,177927067,0,723,8271,177935338
2021-01-08,2406343,173745916,6000,6723,78457,173824373
2021-01-11,3296168,175268143,0,4423,50953,175319096
2021-01-12,3103447,173569134,14300,15923,183433,173752567
2021-01-13,2558211,169175667,5100,20123,220347,169396014
2021-01-14,1799500,168584860,0,3523,38929,168623789
2021-01-15,793540,166674574,0,723,8090,166682664
2021-01-18,1069948,165852150,0,723,8213,165860363
2021-01-19,2964879,166573239,3700,4423,52059,166625298
2021-01-20,2466076,167153455,18200,22623,262653,167416108
2021-01-21,2769993,167788749,0,4423,51351,167840100
2021-01-22,4639264,168299959,5000,9423,106668,168406627
2021-01-25,2430114,167553535,0,9423,104407,167657942
2021-01-26,717311,166230909,0,9423,105255,166336164
2021-01-27,1822380,165745301,10000,19423,221422,165966723
2021-01-28,4724716,167286840,0,4423,50422,167337262
2021-01-29,1633291,163762758,3500,7923,85965,163848723
2021-02-01,3710726,162030289,5700,13623,158572,162188861
2021-02-02,4145740,162702850,0,7923,93412,162796262
2021-02-03,2047215,161546785,0,7923,92065,161638850
2021-02-04,1862383,161418497,0,4223,47044,161465541
2021-02-05,2271613,162120738,0,4223,46537,162167275
2021-02-08,774131,161032244,0,4223,46791,161079035
2021-02-09,5462448,157425866,8800,11323,115042,157540908
2021-02-10,2758472,156367931,300,2823,28428,156396359
2021-02-18,5527507,157997452,3700,6223,64346,158061798
2021-02-19,2928535,157066471,0,2523,27072,157093543
2021-02-22,5839390,157343750,3700,4423,47636,157391386
2021-02-23,2987818,157847682,0,723,7664,157855346
2021-02-24,4457844,159418419,3700,4423,48122,159466541
2021-02-25,4663698,162699862,0,4423,46751,162746613
2021-02-26,2482610,163225428,0,723,7649,163233077
2021-03-01,2820096,163212223,3700,4423,48122,163260345
2021-03-02,2404871,162830822,0,723,7830,162838652
2021-03-03,1376076,160254471,0,723,7852,160262323
2021-03-04,1806924,160331547,3700,4423,47768,160379315
2021-03-05,3584979,160844198,0,723,7946,160852144
2021-03-08,2440358,161171185,3700,4423,48299,161219484
2021-03-09,3134337,162485200,0,4423,46486,162531686
2021-03-10,1989192,162982724,0,723,7440,162990164
2021-03-11,1198609,161481527,0,723,7635,161489162
2021-03-12,1302683,161290797,3800,4523,47130,161337927
2021-03-15,1862257,162128986,0,4423,45292,162174278
2021-03-16,1273869,161280238,100,823,8559,161288797
2021-03-17,914169,161110563,3800,4523,47039,161157602
2021-03-18,3878352,152301201,0,723,7324,152308525
2021-03-19,2445713,151321188,3700,4423,44982,151366170
2021-03-22,1622234,149425707,0,4423,45822,149471529
2021-03-23,1683257,149085256,0,4423,45867,149131123
2021-03-24,1270427,148082899,0,723,7512,148090411
2021-03-25,1698262,148017260,0,723,7577,148024837
2021-03-26,943737,147056949,0,723,7613,147064562
2021-03-29,2967319,148790206,3700,4423,45557,148835763
2021-03-30,2648767,149178101,0,4423,44805,149222906
2021-03-31,2529254,149696678,0,4423,45159,149741837
2021-04-01,1237082,150100163,0,4423,44761,150144924
2021-04-02,2362117,148287313,0,4423,45203,148332516
2021-04-06,5070617,150718053,0,3723,38608,150756661
2021-04-07,2257648,151121519,0,3723,38682,151160201
2021-04-08,1489596,146858321,100,3823,39033,146897354
2021-04-09,813436,146821987,0,3723,38347,146860334
2021-04-12,677936,144371223,0,3723,37751,144408974
2021-04-13,747752,143173900,100,3823,39109,143213009
2021-04-14,2203430,142850247,100,3823,39530,142889777
2021-04-15,4061261,143529915,0,3723,38682,143568597
2021-04-16,3589734,139998334,0,3723,39836,140038170
2021-04-19,4287234,137918776,0,3723,40395,137959171
2021-04-20,2233941,136563016,0,3723,40022,136603038
2021-04-21,6171465,140424219,0,3723,40730,140464949
2021-04-22,2489465,139742484,0,3723,40432,139782916
2021-04-23,2377317,139371257,0,3723,39762,139411019
2021-04-26,4081490,140714728,0,3723,39538,140754266
2021-04-27,1675075,139585260,100,3823,41288,139626548
2021-04-28,4719587,142730592,0,3723,39762,142770354
2021-04-29,3795790,143264617,0,3723,40469,143305086
2021-04-30,5038948,143967789,0,3723,39538,144007327
2021-05-06,2230376,145206905,4300,4323,46040,145252945
2021-05-07,2601140,143844585,3700,7423,79055,143923640
2021-05-10,5158161,145436909,0,7423,76383,145513292
2021-05-11,545174,141038261,21400,28823,326276,141364537
2021-05-12,19314978,148523922,0,28823,333770,148857692
2021-05-13,6745371,148121011,0,25123,285397,148406408
2021-05-14,7847324,149430956,3700,7423,84400,149515356
2021-05-17,11272992,149550962,23637,31060,368993,149919955
2021-05-18,8314854,152271636,0,31060,362159,152633795
2021-05-19,9152847,152426136,0,31060,369925,152796061
2021-05-20,7198399,152236693,0,31060,361539,152598232
2021-05-21,4777053,152389673,0,31060,356879,152746552
2021-05-24,7604555,154166695,900,31960,375530,154542225
2021-05-25,12921317,157725987,0,31060,372410,158098397
2021-05-26,7100152,159288773,0,27360,322301,159611074
2021-05-27,7321737,161193643,700,28060,332792,161526435
2021-05-28,12715827,164206946,3700,31060,376137,164583083
2021-05-31,9881779,166046843,0,31060,375515,166422358
2021-06-01,8691569,164710173,500,10823,129335,164839508
2021-06-02,9056845,166166625,0,10323,119953,166286578
2021-06-03,6009595,166418322,0,7423,84696,166503018
2021-06-04,5101648,167307592,0,7423,86107,167393699
2021-06-07,5578835,168318338,0,7423,86923,168405261
2021-06-08,4557763,164583963,3700,11123,128026,164711989
2021-06-09,4868562,165217512,900,8323,97546,165315058
2021-06-10,8771261,165048092,0,7423,88334,165136426
2021-06-11,6094700,164427722,5000,12423,142865,164570587
2021-06-15,16360922,169865495,13300,24423,296495,170161990
2021-06-16,8997858,173486943,5600,30023,369283,173856226
2021-06-17,8274887,174354840,900,27223,331304,174686144
2021-06-18,8777544,173591936,3700,17923,221170,173813106
2021-06-21,10182387,176433045,0,16023,195801,176628846
2021-06-22,5937725,173360444,1200,17223,209259,173569703
2021-06-23,4203356,169472527,400,14323,174168,169646695
2021-06-24,5872801,162557187,3300,12023,140068,162697255
2021-06-25,6045562,165588044,6100,17323,201986,165790030
2021-06-28,2042360,161855706,200,17523,205545,162061251
2021-06-29,4893155,162223078,900,12123,138566,162361644
2021-06-30,12801366,164853231,14200,22523,263970,165117201
2021-07-01,6305506,164988982,3700,12023,136221,165125203
2021-07-02,4277520,166081205,0,12023,135018,166216223
2021-07-05,2869037,166874981,0,4623,52517,166927498
2021-07-06,3796722,167956069,3900,8523,97247,168053316
2021-07-07,4170496,169045550,0,7423,84325,169129875
2021-07-08,3585911,167826845,0,7423,85736,167912581
2021-07-09,5676830,168124098,4300,11723,136104,168260202
2021-07-12,8193170,171106875,0,3723,44118,171150993
2021-07-13,6681948,170906305,3700,7423,88037,170994342
2021-07-14,5647657,166706916,0,7423,86107,166793023
2021-07-15,4007881,163335323,0,7423,85290,163420613
2021-07-16,3276103,161866329,0,7223,81331,161947660
2021-07-19,2058115,160240878,7000,14223,157449,160398327
2021-07-20,2365195,160418869,0,7523,83656,160502525
2021-07-21,2284301,159294713,14900,18723,211008,159505721
2021-07-22,3274767,156232175,3700,22423,250016,156482191
2021-07-23,5745608,159625531,0,22423,247550,159873081
2021-07-26,3861334,161103877,0,22423,236787,161340664
2021-07-27,1575438,160195890,0,19123,201556,160397446
2021-07-28,1823015,160184174,6200,24923,254713,160438887
2021-07-29,606041,158149110,0,19123,197349,158346459
2021-07-30,1904840,158391894,3300,22423,235666,158627560
2021-08-02,1467955,157129972,0,18723,200898,157330870
2021-08-03,2542985,155143705,0,18723,199213,155342918
2021-08-04,5712603,157822786,3700,22423,239702,158062488
2021-08-05,2524506,155456912,0,22423,231854,155688766
2021-08-06,873153,154649861,0,22423,234320,154884181
2021-08-09,1789616,154749866,0,18723,196779,154946645
2021-08-10,3523907,153897808,0,18723,199774,154097582
2021-08-11,2677892,155049396,3700,22423,238132,155287528
2021-08-12,1543526,153673121,0,18723,199774,153872895
2021-08-13,2295239,151751082,0,18723,198838,151949920
2021-08-16,4483742,151288654,0,18723,201272,151489926
2021-08-17,3035032,151023877,7000,25723,266490,151290367
2021-08-18,1468480,150881068,0,18623,193307,151074375
2021-08-19,2030325,151103267,3700,22323,231936,151335203
2021-08-20,1769819,148503242,0,22323,228364,148731606
2021-08-23,1534268,147828388,0,18623,194424,148022812
2021-08-24,1509453,147763352,3700,22323,231713,147995065
2021-08-25,1937475,148144110,0,22323,233945,148378055
2021-08-26,2038584,148405690,0,22323,231936,148637626
2021-08-27,3054260,146554097,0,22323,233052,146787149
2021-08-30,2432893,146517029,0,18623,193307,146710336
2021-08-31,2072101,146526063,3700,22323,231266,146757329
2021-09-01,5371333,148975349,0,22323,236401,149211750
2021-09-02,4292256,150588731,0,22323,237293,150826024
2021-09-03,3087290,147833169,0,18623,199080,148032249
2021-09-06,5293054,149480062,0,14923,161467,149641529
2021-09-07,6189014,151776624,9000,9023,97719,151874343
2021-09-08,6714102,150837655,0,9023,99433,150937088
2021-09-09,6084351,152386414,0,9023,98170,152484584
2021-09-10,6255820,154624244,0,9023,97448,154721692
2021-09-13,5101018,154531581,0,9023,99253,154630834
2021-09-14,6005890,156392186,7000,12323,132472,156524658
2021-09-15,1482433,155638358,3700,9023,97358,155735716
2021-09-16,3675162,157115815,16400,21723,233739,157349554
2021-09-17,6332325,155606573,3700,9023,100787,155707360
2021-09-22,5502020,156209259,4000,9823,111295,156320554
2021-09-23,5789561,158021092,9700,15023,167657,158188749
2021-09-24,4127728,159156650,3700,9023,98982,159255632
2021-09-27,2357434,152427946,0,1623,17269,152445215
2021-09-28,1878799,152395469,2100,3723,39687,152435156
2021-09-29,2342870,152319366,100,3823,39453,152358819
2021-09-30,2082301,151219689,0,123,1287,151220976
2021-10-08,1647833,151458876,0,23,247,151459123
2021-10-11,1063635,151446329,0,23,247,151446576
2021-10-12,911193,151670389,3700,3723,39613,151710002
2021-10-13,725116,150504527,0,3723,39538,150544065
2021-10-14,971468,149522340,0,3723,39836,149562176
2021-10-15,813880,149220052,0,3723,39166,149259218
2021-10-18,1625079,147741507,0,3723,39427,147780934
2021-10-19,843822,146442258,0,23,244,146442502
2021-10-20,1698358,145083064,0,23,240,145083304
2021-10-21,1246393,145154501,0,23,239,145154740
2021-10-22,1116634,144374237,0,23,237,144374474
2021-10-25,541706,143470692,3700,3723,38161,143508853
2021-10-26,648649,143127801,0,3723,38347,143166148
2021-10-27,4332825,137026851,0,3723,34959,137061810
2021-10-28,1658686,136129488,100,123,1149,136130637
2021-10-29,1617178,133742331,3700,3823,36051,133778382
2021-11-01,1373041,133968882,0,3823,36166,134005048
2021-11-02,1917941,131946744,0,3823,35248,131981992
2021-11-03,1411471,131372744,0,123,1149,131373893
2021-11-04,1366854,131009069,3700,3823,35974,131045043
2021-11-05,2982651,131559758,0,3723,35852,131595610
2021-11-08,2049552,129658866,0,3723,36969,129695835
2021-11-09,2154909,129907772,0,3723,37156,129944928
2021-11-10,1016146,129264946,0,23,229,129265175
2021-11-11,1531975,127286143,100,123,1239,127287382
2021-11-12,629477,126018969,2500,2623,26755,126045724
2021-11-15,700420,124451277,0,23,237,124451514
2021-11-16,1725698,124264984,1800,1823,18522,124283506
2021-11-17,717558,124223498,0,923,9488,124232986
2021-11-18,922141,123016092,5800,5823,58638,123074730
2021-11-19,2623836,123758772,0,1623,16701,123775473
2021-11-22,1028511,123965890,0,1623,16620,123982510
2021-11-23,1138403,122768254,3700,4223,44384,122812638
2021-11-24,1356186,123512154,0,3823,39797,123551951
2021-11-25,505607,122755108,0,3823,39759,122794867
2021-11-26,1833989,122526871,0,3823,39645,122566516
2021-11-29,1964907,122686867,0,3823,38918,122725785
2021-11-30,3343233,122549283,0,123,1287,122550570
2021-12-01,12570879,132129006,5800,5923,62488,132191494
2021-12-02,2094814,132177083,0,5923,61599,132238682
2021-12-03,6889460,136716762,0,2223,23297,136740059
2021-12-06,9234611,142036892,0,2223,23075,142059967
2021-12-07,5804791,141373751,0,2223,23586,141397337
2021-12-08,4461201,143230476,3700,5923,62961,143293437
2021-12-09,5391358,146398888,0,5923,63791,146462679
2021-12-10,3024703,147118122,0,5923,64442,147182564
2021-12-13,3175432,147202481,11300,13423,147385,147349866
2021-12-14,3193124,147174784,3700,17123,188182,147362966
2021-12-15,3499260,145722217,1900,19023,207160,145929377
2021-12-16,1470062,142178053,0,17123,188867,142366920
2021-12-17,16028883,151443000,4500,21623,246502,151689502
2021-12-20,5174045,152320918,0,17923,199662,152520580
2021-12-21,3551740,153833781,200,13623,152033,153985814
2021-12-22,2915818,154875760,9600,23223,259401,155135161
2021-12-23,3644977,154583317,2100,12423,135783,154719100
2021-12-24,4704015,153945505,6100,18523,222646,154168151
2021-12-27,13435259,157899411,5400,16223,193378,158092789
2021-12-28,14785375,161342943,6100,17523,217285,161560228
2021-12-29,9911360,163630689,11300,22723,269268,163899957
2021-12-30,7279491,165784777,4700,19523,229786,166014563
2021-12-31,5347004,163106887,300,19823,236092,163342979
2022-01-04,14409657,166125822,300,20123,247110,166372932
2022-01-05,9044959,168914793,2700,22823,276843,169191636
2022-01-06,8004214,168252094,5200,28023,346084,168598178
2022-01-07,13031490,175457191,0,11423,136391,175593582
2022-01-10,11335226,158156736,8300,19723,244960,158401696
2022-01-11,3814192,156268145,600,20323,249566,156517711
