日期,融资买入额(元),融资余额(元),融券卖出量,融券余量,融券余额(元),融资融券余额(元)
2017-07-12,7797862,352769524,1000,6000,61800,352831324
2017-07-13,3412458,349563127,0,6000,61980,349625107
2017-07-14,2002301,347438595,0,0,0,347438595
2017-07-17,11249987,343454921,0,0,0,343454921
2017-07-18,4397552,341653035,0,0,0,341653035
2017-07-19,4880403,341167140,0,0,0,341167140
2017-07-20,4936032,340209378,0,0,0,340209378
2017-07-21,2518798,336513254,0,0,0,336513254
2017-07-24,4709976,335428792,0,0,0,335428792
2017-07-25,3717829,335965123,0,0,0,335965123
2017-07-26,4623196,336074851,0,0,0,336074851
2017-07-27,11707517,339752922,0,0,0,339752922
2017-07-28,3747378,335137549,0,0,0,335137549
2017-07-31,11999894,337344486,0,0,0,337344486
2017-08-01,4611811,333186615,0,0,0,333186615
2017-08-02,4240673,331491651,300,300,2931,331494582
2017-08-03,5110296,330804812,0,300,2958,330807770
2017-08-04,3809174,327816006,0,300,2970,327818976
2017-08-07,2813567,325569074,0,300,2970,325572044
2017-08-08,6758553,328508180,0,300,2952,328511132
2017-08-09,4074229,328398480,0,300,2955,328401435
2017-08-10,5066586,324867007,0,0,0,324867007
2017-08-11,4776596,320502017,0,0,0,320502017
2017-08-14,4753238,320507892,2100,2100,20328,320528220
2017-08-15,3522829,320098598,0,2100,20622,320119220
2017-08-16,8962361,321196311,0,2100,20811,321217122
2017-08-17,7846071,319783279,0,2100,20958,319804237
2017-08-18,4837233,314766175,0,2100,20958,314787133
2017-08-21,3804027,308751621,0,2100,21000,308772621
2017-08-22,4722362,309480765,0,2100,20958,309501723
2017-08-23,4665859,308820451,0,2100,20790,308841241
2017-08-24,2054105,308030590,0,2100,20454,308051044
2017-08-25,4990575,308794628,0,2100,20811,308815439
2017-08-28,16504970,307249704,0,0,0,307249704
2017-08-29,6585933,300729310,0,0,0,300729310
2017-08-30,5914876,298098459,0,0,0,298098459
2017-08-31,6149794,297435691,0,0,0,297435691
2017-09-01,10183197,297553358,0,0,0,297553358
2017-09-04,10815336,298670890,0,0,0,298670890
2017-09-05,20451551,302197116,0,0,0,302197116
2017-09-06,11751788,298427945,0,0,0,298427945
2017-09-07,14262513,294292527,0,0,0,294292527
2017-09-08,8393710,290637725,0,0,0,290637725
2017-09-11,12656068,292437770,0,0,0,292437770
2017-09-12,8281076,293156588,0,0,0,293156588
2017-09-13,6202541,294441936,0,0,0,294441936
2017-09-14,6474812,292317957,0,0,0,292317957
2017-09-15,5922901,290447156,0,0,0,290447156
2017-09-18,6460748,289492779,0,0,0,289492779
2017-09-19,7100275,290451077,0,0,0,290451077
2017-09-20,11573555,289393778,0,0,0,289393778
2017-09-21,16177322,294055886,0,0,0,294055886
2017-09-22,7974778,293580683,0,0,0,293580683
2017-09-25,6634247,294695341,0,0,0,294695341
2017-09-26,6323962,294905804,0,0,0,294905804
2017-09-27,10077078,294172174,0,0,0,294172174
2017-09-28,8546600,295096083,0,0,0,295096083
2017-09-29,3381581,290573836,0,0,0,290573836
2017-10-09,21239797,290882724,0,0,0,290882724
2017-10-10,16905187,295635597,0,0,0,295635597
2017-10-11,19095378,302920877,0,0,0,302920877
2017-10-12,14267128,306481860,0,0,0,306481860
2017-10-13,22950549,306315749,0,0,0,306315749
2017-10-16,27971044,314174197,0,0,0,314174197
2017-10-17,7129936,313566497,0,0,0,313566497
2017-10-18,9685799,313799204,0,0,0,313799204
2017-10-19,10583879,312594809,0,0,0,312594809
2017-10-20,2839346,310212373,0,0,0,310212373
2017-10-23,5325842,311005993,0,0,0,311005993
2017-10-24,2580954,307710238,0,0,0,307710238
2017-10-25,4794135,305190432,0,0,0,305190432
2017-10-26,7693510,308342626,0,0,0,308342626
2017-10-27,6384280,304815704,0,0,0,304815704
2017-10-30,11729429,309257043,0,0,0,309257043
2017-10-31,3151713,308658629,0,0,0,308658629
2017-11-01,4966116,308591126,0,0,0,308591126
2017-11-02,9237484,309250579,0,0,0,309250579
2017-11-03,3637362,307819028,0,0,0,307819028
2017-11-06,6524667,308245657,20000,20000,197400,308443057
2017-11-07,5245668,306827245,0,0,0,306827245
2017-11-08,6758778,304888986,0,0,0,304888986
2017-11-09,5385938,304410122,0,0,0,304410122
2017-11-10,28120260,309785826,0,0,0,309785826
2017-11-13,15032068,310151937,0,0,0,310151937
2017-11-14,9217002,310248559,0,0,0,310248559
2017-11-15,8301058,309295428,0,0,0,309295428
2017-11-16,0,307100772,0,0,0,307100772
2017-11-17,0,304747893,0,0,0,304747893
2017-11-20,0,303063156,0,0,0,303063156
2017-11-21,0,301164893,0,0,0,301164893
2017-11-22,0,300503392,0,0,0,300503392
2017-11-23,0,299807479,0,0,0,299807479
2017-11-24,0,298566237,0,0,0,298566237
2017-11-27,0,298122794,0,0,0,298122794
2017-11-28,0,294286169,0,0,0,294286169
2017-11-29,0,293507843,0,0,0,293507843
2017-11-30,0,290875099,0,0,0,290875099
2017-12-01,0,290243841,0,0,0,290243841
2017-12-04,0,288821847,0,0,0,288821847
2017-12-05,0,287546395,0,0,0,287546395
2017-12-06,0,286541180,0,0,0,286541180
2017-12-07,0,285981675,0,0,0,285981675
2017-12-08,0,284266785,0,0,0,284266785
2017-12-11,0,283863118,0,0,0,283863118
2017-12-12,0,283581770,0,0,0,283581770
2017-12-13,0,282407704,0,0,0,282407704
2017-12-14,0,280858916,0,0,0,280858916
2017-12-15,0,280233615,0,0,0,280233615
2017-12-18,0,279909177,0,0,0,279909177
2017-12-19,0,279580560,0,0,0,279580560
2017-12-20,0,279364841,0,0,0,279364841
2017-12-21,0,278142076,0,0,0,278142076
2017-12-22,0,277183746,0,0,0,277183746
2017-12-25,0,276946697,0,0,0,276946697
2017-12-26,0,276733496,0,0,0,276733496
2017-12-27,0,276410435,0,0,0,276410435
2017-12-28,0,275817075,0,0,0,275817075
2017-12-29,0,273595336,0,0,0,273595336
2018-01-02,0,271034975,0,0,0,271034975
2018-01-03,0,270855275,0,0,0,270855275
2018-01-04,0,270341198,0,0,0,270341198
2018-01-05,0,270026409,0,0,0,270026409
2018-01-08,0,269735068,0,0,0,269735068
2018-01-09,0,269174142,0,0,0,269174142
2018-01-10,0,268229316,0,0,0,268229316
2018-01-11,0,267869235,0,0,0,267869235
2018-01-12,0,267386819,0,0,0,267386819
2018-01-15,0,266726401,0,0,0,266726401
2018-01-16,0,266630307,0,0,0,266630307
2018-01-17,0,266309101,0,0,0,266309101
2018-01-18,0,266206267,0,0,0,266206267
2018-01-19,0,265447481,0,0,0,265447481
2018-01-22,0,264929184,0,0,0,264929184
2018-01-23,0,264676392,0,0,0,264676392
2018-01-24,0,264412530,0,0,0,264412530
2018-01-25,0,264069680,0,0,0,264069680
2018-01-26,0,263703143,0,0,0,263703143
2018-01-29,0,263294393,0,0,0,263294393
2018-01-30,0,262781434,0,0,0,262781434
2018-01-31,0,262669872,0,0,0,262669872
2018-02-01,0,260932124,0,0,0,260932124
2018-02-02,0,259305077,0,0,0,259305077
2018-02-05,6150194,249205121,0,0,0,249205121
2018-02-06,10076805,246165935,0,0,0,246165935
2018-02-07,12961616,244284883,0,0,0,244284883
2018-02-08,0,242325144,0,0,0,242325144
2018-02-09,0,240343786,0,0,0,240343786
2018-02-12,0,238612936,0,0,0,238612936
2018-02-13,5062390,237929927,0,0,0,237929927
2018-02-14,1816368,235550120,0,0,0,235550120
2018-02-22,6220252,237466323,0,0,0,237466323
2018-02-23,2791303,236229076,0,0,0,236229076
2018-02-26,4526983,236163313,0,0,0,236163313
2018-02-27,5971131,236523296,0,0,0,236523296
2018-02-28,2593563,235488379,0,0,0,235488379
2018-03-01,5761512,236528433,0,0,0,236528433
2018-03-02,7711026,238751685,0,0,0,238751685
2018-03-05,3653038,237389595,0,0,0,237389595
2018-03-06,3241256,237261989,0,0,0,237261989
2018-03-07,6381072,238171722,0,0,0,238171722
2018-03-08,4492555,238588771,0,0,0,238588771
2018-03-09,10527738,242601193,0,0,0,242601193
2018-03-12,9841944,241704525,0,0,0,241704525
2018-03-13,7160298,242665570,0,0,0,242665570
2018-03-14,6595319,243410512,0,0,0,243410512
2018-03-15,11819175,250537113,0,0,0,250537113
2018-03-16,6665967,253051338,0,0,0,253051338
2018-03-19,4298531,250966809,0,0,0,250966809
2018-03-20,4335232,247785900,0,0,0,247785900
2018-03-21,6320117,248814451,0,0,0,248814451
2018-03-22,4838044,245129968,16900,16900,144326,245274294
2018-03-23,8387379,238804068,0,0,0,238804068
2018-03-26,4589082,239330312,0,0,0,239330312
2018-03-27,2954413,232887402,0,0,0,232887402
2018-03-28,4752958,234641366,0,0,0,234641366
2018-03-29,5620742,233921318,0,0,0,233921318
2018-03-30,9428094,235655918,0,0,0,235655918
2018-04-02,12444427,234645846,0,0,0,234645846
2018-04-03,9860513,238252005,0,0,0,238252005
2018-04-04,7853747,239895826,0,0,0,239895826
2018-04-09,6776229,243472207,0,0,0,243472207
2018-04-10,4465382,243073026,0,0,0,243073026
2018-04-11,9014417,244966988,0,0,0,244966988
2018-04-12,6254741,246972762,0,0,0,246972762
2018-04-13,3651994,246798243,0,0,0,246798243
2018-04-16,5782120,248561906,0,0,0,248561906
2018-04-17,4769784,245837875,0,0,0,245837875
2018-04-18,6517521,241847324,0,0,0,241847324
2018-04-19,16209004,244455370,0,0,0,244455370
2018-04-20,12115148,242423745,0,0,0,242423745
2018-04-23,23362455,245550876,0,0,0,245550876
2018-04-24,40753634,253885392,0,0,0,253885392
2018-04-25,29277568,257168358,39800,39800,393224,257561582
2018-04-26,22293129,262967975,25000,40000,387200,263355175
2018-04-27,16960592,262189518,10000,10000,95200,262284718
2018-05-02,14852931,262969465,0,5000,47400,263016865
2018-05-03,22047482,265522377,67100,67100,663619,266185996
2018-05-04,16177601,261897264,0,60000,573000,262470264
2018-05-07,19603210,261570103,0,0,0,261570103
2018-05-08,12532436,257906193,0,0,0,257906193
2018-05-09,8960155,258997221,5000,5000,47400,259044621
2018-05-10,10170470,262408840,0,5000,47450,262456290
2018-05-11,10765931,261719529,15000,15000,139950,261859479
2018-05-14,7431210,261152674,0,15000,140700,261293374
2018-05-15,9284665,264839468,0,0,0,264839468
2018-05-16,9694825,264090804,0,0,0,264090804
2018-05-17,8099205,264312475,0,0,0,264312475
2018-05-18,4399128,265556363,0,0,0,265556363
2018-05-21,14632989,269275833,0,0,0,269275833
2018-05-22,18467301,275954911,12900,12900,123453,276078364
2018-05-23,8950266,276072354,0,12900,122550,276194904
2018-05-24,8561377,278432395,0,12900,122292,278554687
2018-05-25,12186342,279459518,0,12900,122292,279581810
2018-05-28,8022701,280689971,0,12900,121131,280811102
2018-05-29,9264403,281542085,0,12900,115842,281657927
2018-05-30,8795661,278158492,0,12900,106038,278264530
2018-05-31,4093084,276758476,0,12900,109263,276867739
2018-06-01,4154282,277494929,0,12900,109392,277604321
2018-06-04,2451506,274413680,0,12900,111714,274525394
2018-06-05,4027245,274222800,0,12900,113778,274336578
2018-06-06,3400258,273574008,0,12900,115326,273689334
2018-06-07,4867707,273624491,0,12900,112359,273736850
2018-06-08,6696293,273031481,0,12900,115842,273147323
2018-06-11,12616244,274660552,0,12900,121389,274781941
2018-06-12,9968060,276423347,0,12900,120357,276543704
2018-06-13,6792524,274283279,0,12900,114552,274397831
2018-06-14,8209475,275954099,0,12900,116616,276070715
2018-06-15,6848130,274983367,0,12900,112101,275095468
2018-06-19,5044228,267103537,0,12900,102297,267205834
2018-06-20,4458962,263391292,0,12900,107457,263498749
2018-06-21,4041417,261478442,0,12900,106038,261584480
2018-06-22,3707106,261451680,0,12900,108102,261559782
2018-06-25,3700072,260422012,0,12900,108489,260530501
2018-06-26,6314035,253663216,0,12900,110553,253773769
2018-06-27,5143259,253117326,0,12900,108489,253225815
2018-06-28,5223955,252043647,0,12900,110424,252154071
2018-06-29,10521120,256786643,0,12900,114165,256900808
2018-07-02,6731509,257483139,0,12900,112617,257595756
2018-07-03,6034446,258034514,0,12900,114423,258148937
2018-07-04,5257139,259259751,0,12900,111714,259371465
2018-07-05,6054001,259273494,0,0,0,259273494
2018-07-06,8082629,255734822,0,0,0,255734822
2018-07-09,7724635,256450803,0,0,0,256450803
2018-07-10,5590205,256792225,12900,12900,114036,256906261
2018-07-11,4069180,254338949,0,12900,110682,254449631
2018-07-12,10299564,257431630,0,12900,114939,257546569
2018-07-13,7076576,255888441,0,12900,117003,256005444
2018-07-16,20739257,259107359,0,12900,121260,259228619
2018-07-17,14485776,258561876,0,12900,123066,258684942
2018-07-18,23608866,260902447,0,12900,125259,261027706
2018-07-19,12975238,260713187,0,12900,123195,260836382
2018-07-20,13686255,263683164,0,12900,122679,263805843
2018-07-23,7390391,260952743,0,12900,122808,261075551
2018-07-24,12311564,262999952,0,12900,123066,263123018
2018-07-25,20245582,259647126,50000,62900,624597,260271723
2018-07-26,16239250,253606919,0,62900,596292,254203211
2018-07-27,11018495,255645886,0,12900,119196,255765082
2018-07-30,15420824,261074143,0,12900,117390,261191533
2018-07-31,5357784,262415111,0,12900,118035,262533146
2018-08-01,6010060,260912251,0,12900,118551,261030802
2018-08-02,10122294,262154279,0,12900,112359,262266638
2018-08-03,3168248,260915506,0,12900,109650,261025156
2018-08-06,3044487,259310861,0,12900,111456,259422317
2018-08-07,5201825,260015804,0,12900,113649,260129453
2018-08-08,4339865,257075674,0,12900,109650,257185324
2018-08-09,6061619,259063699,0,12900,113262,259176961
2018-08-10,4685203,256669692,0,12900,113907,256783599
2018-08-13,6510580,255875826,0,12900,117003,255992829
2018-08-14,11059070,259147663,0,12900,119325,259266988
2018-08-15,10310973,256380714,0,12900,113649,256494363
2018-08-16,7543502,256653153,0,12900,111456,256764609
2018-08-17,4707976,255175131,0,12900,109392,255284523
2018-08-20,6373871,255877849,0,12900,111972,255989821
2018-08-21,5346855,255961940,0,12900,112617,256074557
2018-08-22,2373040,255443367,0,12900,111456,255554823
2018-08-23,9374221,257237993,0,12900,114165,257352158
2018-08-24,6406243,258208498,0,12900,114810,258323308
2018-08-27,9662374,258989017,0,12900,117906,259106923
2018-08-28,8572014,258028711,0,12900,116616,258145327
2018-08-29,3019716,255461586,0,12900,117132,255578718
2018-08-30,2881326,251896114,0,12900,115971,252012085
2018-08-31,3253168,250226327,0,12900,114810,250341137
2018-09-03,3745234,248618186,8800,21700,195951,248814137
2018-09-04,8403514,248101640,1100,22800,209304,248310944
2018-09-05,6231147,248055383,1000,23800,216342,248271725
2018-09-06,6182120,248755179,0,23800,216104,248971283
2018-09-07,7631851,245665335,0,23800,213962,245879297
2018-09-10,2742088,243789328,0,23800,214914,244004242
2018-09-11,6706655,241080295,0,23800,218722,241299017
2018-09-12,7882813,242512088,0,23800,219436,242731524
2018-09-13,4795251,241021423,400,24200,223850,241245273
2018-09-14,8480065,236917929,5100,25300,240350,237158279
2018-09-17,8017663,237255806,8064,32364,306163,237561969
2018-09-18,11223882,236530849,4100,31664,307774,236838623
2018-09-19,10576928,237370967,7000,38664,373881,237744848
2018-09-20,9963190,238224212,0,35264,335008,238559220
2018-09-21,8167794,236830661,6600,40364,387091,237217752
2018-09-25,10306179,239945887,2500,38164,358742,240304629
2018-09-26,8873434,236594974,7500,43164,410058,237005032
2018-09-27,9359082,231373191,7300,42064,379417,231752608
2018-09-28,7168738,227939738,0,37264,343574,228283312
2018-10-08,6761430,228708116,7300,42064,369322,229077438
2018-10-09,4204130,229307649,4800,40464,354465,229662114
2018-10-10,4601543,228480920,5600,40323,350407,228831327
2018-10-11,8009124,213809082,7300,42023,328620,214137702
2018-10-12,6360810,209041440,7200,41923,321549,209362989
2018-10-15,2257862,204663412,8000,42723,331103,204994515
2018-10-16,2347826,201641767,9400,44823,350516,201992283
2018-10-17,3683940,201344580,7000,43623,341568,201686148
2018-10-18,2482223,200046783,7200,44591,341567,200388350
2018-10-19,4896366,199131085,9600,46991,372169,199503254
2018-10-22,9610965,202988150,11000,50790,423081,203411231
2018-10-23,6855777,203605162,10100,48890,402365,204007527
2018-10-24,3457101,203832884,4400,44288,364933,204197817
2018-10-25,5140247,205373912,7200,47088,392714,205766626
2018-10-26,4678896,205633939,6700,46588,385749,206019688
2018-10-29,2849645,206180814,2100,39588,327789,206508603
2018-10-30,2324070,205170027,7200,44688,371357,205541384
2018-10-31,2824096,203449652,3700,41188,345155,203794807
2018-11-01,6444888,203437662,6300,43788,370884,203808546
2018-11-02,6668835,203631834,5300,42788,367549,203999383
2018-11-05,6758272,199993258,0,38288,323534,200316792
2018-11-06,3405851,196020295,6900,44388,372859,196393154
2018-11-07,2910012,190369748,8500,45988,382620,190752368
2018-11-08,1585159,187395754,1100,38588,323753,187719507
2018-11-09,3422073,188780009,8700,47288,399111,189179120
2018-11-12,4818353,189449376,7000,47769,411291,189860667
2018-11-13,5495727,188481553,700,45469,392397,188873950
2018-11-14,4220870,186582473,500,45969,394414,186976887
2018-11-15,4492700,185967573,7200,53169,467887,186435460
2018-11-16,8098073,187003055,1600,53169,476394,187479449
2018-11-19,2389775,183555166,1100,37169,333034,183888200
2018-11-20,4217846,183624765,2900,40069,349402,183974167
2018-11-21,2078999,182511496,1200,41269,359040,182870536
2018-11-22,2419237,183625386,0,41269,361929,183987315
2018-11-23,5031606,181732407,5300,37869,310526,182042933
2018-11-26,1567258,182583304,400,38169,314513,182897817
2018-11-27,1866700,181660635,39300,76569,642414,182303049
2018-11-28,4636533,178909058,28900,103069,910099,179819157
2018-11-29,5650212,179432269,3000,74669,649620,180081889
2018-11-30,5267745,181194481,6600,74069,636253,181830734
2018-12-03,6059295,181702705,0,74069,659955,182362660
2018-12-04,6815151,182993180,0,74069,662177,183655357
2018-12-05,5040498,181564340,0,74069,665140,182229480
2018-12-06,4839151,179286456,9800,83869,743918,180030374
2018-12-07,9935032,177941610,42900,118377,1076047,179017657
2018-12-10,5156218,177552141,9200,83269,745258,178297399
2018-12-11,5698988,177752685,7800,84969,774917,178527602
2018-12-12,4817253,178080009,11900,95269,853610,178933619
2018-12-13,5532875,177276152,700,95969,884834,178160986
2018-12-14,7889778,176963257,0,92369,811924,177775181
2018-12-17,5026971,177304348,4300,93169,822682,178127030
2018-12-18,7779486,182007581,8200,95769,830317,182837898
2018-12-19,7521077,183111841,0,91969,769781,183881622
2018-12-20,3261796,181406016,0,87969,734541,182140557
2018-12-21,5102503,184682163,31000,81869,663958,185346121
2018-12-24,6065375,183611342,5500,87369,740889,184352231
2018-12-25,12614120,189113985,37300,82969,721830,189835815
2018-12-26,10413785,193928732,29800,76669,657820,194586552
2018-12-27,9468308,192814239,0,65969,564695,193378934
2018-12-28,6268086,191808315,29300,88069,756513,192564828
2019-01-02,20284699,199599903,41600,87169,788879,200388782
2019-01-03,39549342,208729174,37700,63969,593632,209322806
2019-01-04,25472108,213128392,0,32369,303298,213431690
2019-01-07,34142236,221507244,4000,32269,307524,221814768
2019-01-08,18746427,223212150,0,31269,290176,223502326
2019-01-09,60574332,227142454,100200,126269,1289206,228431660
2019-01-10,53396342,240847437,5200,31269,309250,241156687
2019-01-11,34807172,242986826,4600,31869,310723,243297549
2019-01-14,27168930,251756043,1600,32369,315274,252071317
2019-01-15,23043438,251011051,0,32369,314303,251325354
2019-01-16,18398777,248012404,0,32369,306858,248319262
2019-01-17,24482431,242327792,0,30969,284605,242612397
2019-01-18,20034501,239365599,0,30969,282128,239647727
2019-01-21,18703835,245022226,0,30969,286773,245308999
2019-01-22,9939994,243520239,200,31169,285508,243805747
2019-01-23,27318781,251567409,2400,31169,294547,251861956
2019-01-24,23057320,255545113,2600,31069,292359,255837472
2019-01-25,16193370,256295321,3400,31069,285213,256580534
2019-01-28,14860866,257116711,0,31069,286145,257402856
2019-01-29,18189503,250213741,3600,20269,174516,250388257
2019-01-30,5936645,237760464,0,15900,138489,237898953
2019-01-31,15259557,238621257,0,14000,120960,238742217
2019-02-01,12256765,233250982,0,14000,124600,233375582
2019-02-11,21350538,238038736,0,14000,130900,238169636
2019-02-12,45219425,245143899,50000,50100,497493,245641392
2019-02-13,53069964,242130066,5800,55900,571857,242701923
2019-02-14,54671264,251333626,5100,61000,624030,251957656
2019-02-15,50545605,260451329,5100,63000,628740,261080069
2019-02-18,59422123,263666596,5700,13000,136110,263802706
2019-02-19,111288545,280775504,55700,63000,718830,281494334
2019-02-20,66739126,279263050,5700,63000,682920,279945970
2019-02-21,69833341,287504632,5700,63000,668430,288173062
2019-02-22,49548739,288783241,5700,62900,684981,289468222
2019-02-25,73039638,284442041,5700,12900,149253,284591294
2019-02-26,63301447,288201453,55700,62900,698190,288899643
2019-02-27,47465697,296460767,5700,62900,702593,297163360
2019-02-28,23735003,293958416,5700,62900,696303,294654719
2019-03-01,30309204,294163810,5700,12900,140997,294304807
2019-03-04,67916525,312781438,5700,12900,142029,312923467
2019-03-05,70399345,325703229,6000,13100,149733,325852962
2019-03-06,62815021,334739371,6000,13100,149340,334888711
2019-03-07,71233584,339645697,34500,41600,487552,340133249
2019-03-08,86464459,349054399,6000,41600,485056,349539455
2019-03-11,103349814,382204908,6000,13100,161392,382366300
2019-03-12,62450547,367655282,6000,13100,161523,367816805
2019-03-13,44378151,348765929,6000,13100,153008,348918937
2019-03-14,33267576,333496496,6000,13100,143969,333640465
2019-03-15,26076306,334587153,6000,13100,143314,334730467
2019-03-18,21866439,335333587,0,13100,147244,335480831
2019-03-19,20650160,331724046,6000,13100,147637,331871683
2019-03-20,21117518,323710642,6000,13100,146196,323856838
2019-03-21,25655370,322039381,6000,13200,147972,322187353
2019-03-22,34978025,326938000,5900,13100,150388,327088388
2019-03-25,44010093,335001689,900,13100,153008,335154697
2019-03-26,31404084,337590269,6000,13100,147899,337738168
2019-03-27,21946578,338592322,6000,13100,146589,338738911
2019-03-28,23000441,338201657,6000,13100,145934,338347591
2019-03-29,27450127,343578497,6000,13100,148423,343726920
2019-04-01,40363531,346303408,900,13100,154580,346457988
2019-04-02,51220141,355505882,6000,13100,155628,355661510
2019-04-03,38977762,346313304,10600,17700,213108,346526412
2019-04-04,54579039,355026656,5957,17738,210550,355237206
2019-04-08,36524645,361078608,5900,17638,210950,361289558
2019-04-09,24378599,356517873,6000,17738,212146,356730019
2019-04-10,32621918,362064992,5900,13038,151762,362216754
2019-04-11,25512932,347871198,13700,20838,232344,348103542
2019-04-12,15871892,346078218,5900,13038,147981,346226199
2019-04-15,29435379,351313810,13700,20838,237345,351551155
2019-04-16,39630362,358021777,5900,13084,158316,358180093
2019-04-17,39218470,344471386,11200,18384,225756,344697142
2019-04-18,73331920,364120214,8341,20725,257197,364377411
2019-04-19,45258246,373561492,6000,20825,253857,373815349
2019-04-22,38955879,369524527,5900,20725,249529,369774056
2019-04-23,16226888,361935324,6000,20825,246776,362182100
2019-04-24,28145341,350614832,5900,20725,234193,350849025
2019-04-25,23246049,345915494,6000,20825,218871,346134365
2019-04-26,22461992,342962223,5900,20725,212224,343174447
2019-04-29,21169566,341380364,6000,20825,203460,341583824
2019-04-30,8065512,338074805,5900,13079,128436,338203241
2019-05-06,16536302,335031504,10626,17805,157396,335188900
2019-05-07,12602696,332949554,7600,19405,177944,333127498
2019-05-08,9540238,323958390,7300,20805,188077,324146467
2019-05-09,7807429,320366365,5900,20705,186759,320553124
2019-05-10,24737979,327856738,4300,19105,178059,328034797
2019-05-13,0,325106928,0,19105,178059,325284987
2019-05-14,0,323409194,0,12005,111887,323521081
2019-05-15,0,321638945,0,9826,91578,321730523
2019-05-16,0,320727442,0,7626,71074,320798516
2019-05-17,0,316784909,0,7626,71074,316855983
2019-05-20,0,315143533,0,7626,71074,315214607
2019-05-21,0,313830202,0,7626,71074,313901276
2019-05-22,0,312839346,0,7626,71074,312910420
2019-05-23,0,311352555,0,7626,71074,311423629
2019-05-24,34531101,326580618,0,7626,78167,326658785
2019-05-27,26876226,294639828,2200,9826,102780,294742608
2019-05-28,36306099,304000753,2200,9826,103861,304104614
2019-05-29,24219039,305960659,7200,14826,154487,306115146
2019-05-30,20458838,306199631,2200,9826,98850,306298481
2019-05-31,16606178,305930048,2200,9826,100323,306030371
2019-06-03,16453874,306627982,6600,14826,147074,306775056
2019-06-04,13025088,305043981,7200,14826,140699,305184680
2019-06-05,12547335,300833333,1200,9826,94231,300927564
2019-06-06,10045255,296438989,2200,2200,20152,296459141
2019-06-10,10654307,297024433,14300,14900,141252,297165685
2019-06-11,20499916,301803781,0,14900,147510,301951291
2019-06-12,23076154,306786577,7200,14900,149000,306935577
2019-06-13,16355300,308860947,0,9900,97812,308958759
2019-06-14,15094502,306050441,200,9858,93158,306143599
2019-06-17,5696354,304224057,0,9858,93060,304317117
2019-06-18,6589197,306314065,0,9858,90989,306405054
2019-06-19,28231806,308181922,6200,14858,144568,308326490
2019-06-20,22822431,312777681,2200,9958,96891,312874572
2019-06-21,21002118,315725703,7100,7158,71007,315796710
2019-06-24,13343581,316173705,1800,2258,22580,316196285
2019-06-25,12349301,317141699,2100,2158,21494,317163193
2019-06-26,10346151,319260479,0,2158,21278,319281757
2019-06-27,24091368,320696098,12200,12258,124541,320820639
2019-06-28,17453720,320242058,1700,12158,120729,320362787
2019-07-01,38982668,305688596,2200,2258,24657,305713253
2019-07-02,55612461,326375328,5200,5258,55524,326430852
2019-07-03,22564683,327374991,2397,5355,55210,327430201
2019-07-04,15502664,325936802,900,5255,54284,325991086
2019-07-05,14221435,323381161,1900,6055,61458,323442619
2019-07-08,17566329,317586275,6000,6155,58473,317644748
2019-07-09,12079033,319007618,2600,6155,58965,319066583
2019-07-10,11079603,310616116,5000,11155,108761,310724877
2019-07-11,15498391,317307595,2400,11155,106865,317414460
2019-07-12,18992127,317150316,10900,16055,157018,317307334
2019-07-15,16607710,319863090,5929,6084,59927,319923017
2019-07-16,20358410,312260013,11800,16184,162487,312422500
2019-07-17,32146125,302706013,5900,6084,63943,302769956
2019-07-18,28549747,311862791,16000,16184,163297,312026088
2019-07-19,17708285,311812827,5900,16084,160036,311972863
2019-07-22,9864863,310283268,5900,16092,156414,310439682
2019-07-23,15700577,310181525,2500,6192,61672,310243197
2019-07-24,21936129,300151344,13800,16192,164996,300316340
2019-07-25,25980452,296961205,5500,10892,113495,297074700
2019-07-26,17901970,293340190,300,10992,112778,293452968
2019-07-29,34609190,304635505,10700,20992,220206,304855711
2019-07-30,21908091,303900544,2100,20992,219786,304120330
2019-07-31,21373332,305744731,2100,20892,215188,305959919
2019-08-01,64730953,323177056,2200,20992,225664,323402720
2019-08-02,47609372,327198103,2100,10892,117416,327315519
2019-08-05,50585169,335585718,2200,10992,116625,335702343
2019-08-06,31725442,335969226,2100,9892,103272,336072498
2019-08-07,43132733,325052239,23200,30992,337193,325389432
2019-08-08,28438052,317016542,32100,50892,550143,317566685
2019-08-09,52369680,323559570,12200,60992,673962,324233532
2019-08-12,73809121,331645790,2100,50892,587803,332233593
2019-08-13,52578219,340380209,2200,50992,587428,340967637
2019-08-14,66683990,351398329,12100,60892,683817,352082146
2019-08-15,44450073,353186759,2200,49992,575908,353762667
2019-08-16,51427193,367260581,22100,69892,784887,368045468
2019-08-19,42960896,360733159,12200,79992,933507,361666666
2019-08-20,37761054,345165404,2100,39892,470327,345635731
2019-08-21,40186261,343745973,36000,73792,897311,344643284
2019-08-22,53160189,352020483,2700,64292,776647,352797130
2019-08-23,46402037,344239664,2600,64792,754179,344993843
2019-08-26,27234049,343282650,1800,64692,756249,344038899
2019-08-27,27999865,331633855,2500,65092,760925,332394780
2019-08-28,22241890,324437985,2100,64792,742516,325180501
2019-08-29,16468919,321790714,2100,64692,747840,322538554
2019-08-30,27088582,311566177,2200,40992,457881,312024058
2019-09-02,24554106,305250067,12100,50892,604088,305854155
2019-09-03,25978191,305286896,1800,50992,609354,305896250
2019-09-04,39160244,311661578,2100,40892,492749,312154327
2019-09-05,74251100,331288313,12200,50992,632811,331921124
2019-09-06,53802112,320422800,2100,40892,512786,320935586
2019-09-09,49025796,324465754,12200,50992,662386,325128140
2019-09-10,48541041,317205414,2100,40892,516466,317721880
2019-09-11,31990264,323193034,10500,50792,640487,323833521
2019-09-12,22610972,311755521,1800,50992,648618,312404139
2019-09-16,54688379,315260682,2100,50892,672792,315933474
2019-09-17,36330872,323833137,700,40892,511150,324344287
2019-09-18,19192178,315910060,900,40992,515269,316425329
2019-09-19,0,313884826,0,40992,515269,314400095
2019-09-20,30793405,309946469,2000,40992,518549,310465018
2019-09-23,31486821,310178213,2100,40892,502972,310681185
2019-09-24,19615710,303810455,1600,40992,509121,304319576
2019-09-25,19011206,293295913,2050,40842,481936,293777849
2019-09-26,24087807,299334510,2200,40942,450362,299784872
2019-09-27,8068189,284914097,11200,50942,577173,285491270
2019-09-30,7997744,275733084,0,30842,342963,276076047
2019-10-08,10378522,281598453,0,30842,343888,281942341
2019-10-09,11464941,282142200,0,30842,351599,282493799
2019-10-10,11918607,274504965,500,30942,369757,274874722
2019-10-11,17250762,271737542,0,28742,338293,272075835
2019-10-14,25834533,283637824,0,28742,339443,283977267
2019-10-15,30283466,287263336,12000,39742,478494,287741830
2019-10-16,18387415,286814387,1200,29787,358635,287173022
2019-10-17,9246631,286795692,400,29887,357747,287153439
2019-10-18,9901803,279478462,1500,30187,353792,279832254
2019-10-21,11194973,277012355,10500,30900,376053,277388408
2019-10-22,19702988,283902331,6800,27700,341541,284243872
2019-10-23,24260128,283298586,15400,37800,469854,283768440
2019-10-24,23804316,283872345,11500,34000,419900,284292245
2019-10-25,13078193,280225175,1600,34000,415480,280640655
2019-10-28,26790504,287665690,15300,45700,580847,288246537
2019-10-29,33778363,290243997,5100,35500,424935,290668932
2019-10-30,18812410,288061148,5300,35500,419610,288480758
2019-10-31,20101693,289546177,0,35500,411090,289957267
2019-11-01,13252759,284388766,800,35500,415705,284804471
2019-11-04,12849587,282864181,1600,17100,203490,283067671
2019-11-05,8436513,284275324,0,17100,204174,284479498
2019-11-06,17591790,278971879,2100,15500,176390,279148269
2019-11-07,6213852,276663931,800,15500,177165,276841096
2019-11-08,8106545,273688821,0,10100,116554,273805375
2019-11-11,8783751,272240361,0,10100,113120,272353481
2019-11-12,7112503,272016063,0,10100,112514,272128577
2019-11-13,5945013,273226304,0,10100,111201,273337505
2019-11-14,11990644,270942189,0,10100,115847,271058036
2019-11-15,11795657,269131343,11600,21700,246295,269377638
2019-11-18,11920176,271652927,0,21700,247163,271900090
2019-11-19,16120311,273536579,0,21700,253456,273790035
2019-11-20,17179132,275250169,0,21700,253673,275503842
2019-11-21,10293584,271427377,0,21700,249550,271676927
2019-11-22,20766797,275457090,0,21700,254107,275711197
2019-11-25,11885815,273848433,0,21700,245861,274094294
2019-11-26,11100049,276342777,0,21700,243257,276586034
2019-11-27,10583826,274790173,0,21700,245210,275035383
2019-11-28,7506236,275959442,4500,26200,297370,276256812
2019-11-29,19171560,272837361,0,26200,310470,273147831
2019-12-02,25222483,272494073,0,26200,319378,272813451
2019-12-03,19592883,269356785,0,26200,325666,269682451
2019-12-04,27981354,269653239,0,26100,329904,269983143
2019-12-05,25997447,266874013,100,26200,333526,267207539
2019-12-06,48570534,269120599,0,26200,349246,269469845
2019-12-09,40861844,281029545,0,24100,318843,281348388
2019-12-10,23896536,268695402,0,24100,321494,269016896
2019-12-11,50483306,288455424,0,24100,324868,288780292
2019-12-12,33685054,283200737,1100,25200,342972,283543709
2019-12-13,21089172,276835396,0,17500,238350,277073746
2019-12-16,22834792,268307888,0,17500,246925,268554813
2019-12-17,25470038,263562843,0,17500,246575,263809418
2019-12-18,42557667,274410744,5100,22600,325892,274736636
2019-12-19,15584917,273572164,2600,25200,358344,273930508
2019-12-20,33761285,275738467,8600,33800,486044,276224511
2019-12-23,29539804,268991850,0,33800,462722,269454572
2019-12-24,43285861,261407409,1400,26900,402155,261809564
2019-12-25,49073920,282003590,0,26900,401617,282405207
2019-12-26,63184999,310501901,0,26900,388705,310890606
2019-12-27,56982615,307695329,0,25500,364650,308059979
2019-12-30,31903991,307658821,4000,29500,412705,308071526
2019-12-31,15070693,303052391,0,29500,410640,303463031
2020-01-02,25379921,300428855,800,30300,436320,300865175
2020-01-03,25819478,301209233,0,29500,426570,301635803
2020-01-06,50186326,309157524,0,29500,427750,309585274
2020-01-07,45909484,323713710,4700,32100,457746,324171456
2020-01-08,31518538,328391479,0,32100,447474,328838953
2020-01-09,26775532,327380080,0,27100,383465,327763545
2020-01-10,21055209,305278922,0,26800,382168,305661090
2020-01-13,53902744,314752534,6000,32500,485875,315238409
2020-01-14,50645899,337299765,0,26600,383838,337683603
2020-01-15,20383702,332393977,700,19551,284858,332678835
2020-01-16,17778447,318056522,0,19500,281580,318338102
2020-01-17,28345737,316702728,2300,21800,320678,317023406
2020-01-20,56854739,330775176,5900,27700,434890,331210066
2020-01-21,38946664,327560974,2300,27700,436552,327997526
2020-01-22,40805319,330554957,2300,27700,446801,331001758
2020-01-23,45820747,317013789,1100,23000,350750,317364539
2020-02-03,2250347,310376414,0,19800,271854,310648268
2020-02-04,49479073,305121090,0,7000,94780,305215870
2020-02-05,36219753,308305683,0,6800,93092,308398775
2020-02-06,28862387,296781108,1700,6800,97376,296878484
2020-02-07,45548188,297659468,1700,6800,105264,297764732
2020-02-10,38890257,302082868,1700,6800,108256,302191124
2020-02-11,33314069,308874926,10000,15100,237372,309112298
2020-02-12,49395565,324826851,0,14500,235915,325062766
2020-02-13,45647165,329689942,0,11500,184000,329873942
2020-02-14,50261745,339012745,0,11500,186185,339198930
2020-02-17,57140269,347958251,0,11500,191820,348150071
2020-02-18,65617546,330037345,0,11500,191475,330228820
2020-02-19,51656325,314993036,2500,14000,225400,315218436
2020-02-20,55285389,309583381,500,12000,196800,309780181
2020-02-21,82462475,329107872,2500,14500,247805,329355677
2020-02-24,104282390,358642114,0,14500,263610,358905724
2020-02-25,87102065,348030309,0,14500,260420,348290729
2020-02-26,156050309,386603427,0,14500,255925,386859352
2020-02-27,88090392,389888587,0,14500,245775,390134362
2020-02-28,61373248,368333967,0,14500,221270,368555237
2020-03-02,50232303,375063150,0,14500,232725,375295875
2020-03-03,44037749,352381575,0,14500,231420,352612995
2020-03-04,21892436,349938262,0,14000,220920,350159182
2020-03-05,38102559,356538005,0,7000,110950,356648955
2020-03-06,25605434,359745512,0,4500,70155,359815667
2020-03-09,33435250,346711453,10000,14500,208075,346919528
2020-03-10,34775675,341814382,0,4500,68355,341882737
2020-03-11,23918842,325181725,0,4500,66690,325248415
2020-03-12,16938193,321933884,3500,8000,117360,322051244
2020-03-13,22900014,319232576,4700,9200,134228,319366804
2020-03-16,23665771,307850350,0,6500,87555,307937905
2020-03-17,17892685,309521818,2000,8500,114835,309636653
2020-03-18,15704859,304098255,1200,9700,129398,304227653
2020-03-19,19465617,306553198,4800,13800,189060,306742258
2020-03-20,14895210,306947748,0,9000,123480,307071228
2020-03-23,10164896,305801619,0,9000,116910,305918529
2020-03-24,14530974,308435735,0,4500,60030,308495765
2020-03-25,14659048,307199611,0,4500,61155,307260766
2020-03-26,10501738,301271363,10000,14500,192705,301464068
2020-03-27,6855533,294707549,0,4500,58860,294766409
2020-03-30,13351908,286321655,10000,14500,180960,286502615
2020-03-31,5610275,281046923,0,14500,181250,281228173
2020-04-01,16074509,281905862,0,4500,58230,281964092
2020-04-02,23837035,286230031,6800,11300,153793,286383824
2020-04-03,36544956,294848214,3200,14100,200784,295048998
2020-04-07,36710567,295516988,400,11200,160496,295677484
2020-04-08,15642685,289532237,0,8400,119532,289651769
2020-04-09,17423946,285818165,0,8400,118944,285937109
2020-04-10,14349737,280786184,0,8400,113820,280900004
2020-04-13,7539021,277526583,1300,9700,126585,277653168
2020-04-14,17193006,280435209,0,8400,115248,280550457
2020-04-15,20249880,286099615,0,8400,114576,286214191
2020-04-16,8491337,278498602,0,8400,114828,278613430
2020-04-17,14044852,273803876,0,8400,115332,273919208
2020-04-20,12389658,271753792,0,8400,115752,271869544
2020-04-21,11646868,274828559,0,8400,114240,274942799
2020-04-22,14552884,274552421,0,8400,118356,274670777
2020-04-23,16323677,277437897,5000,13400,182910,277620807
2020-04-24,12699685,277190390,0,8400,110376,277300766
2020-04-27,6783951,276848096,1100,9500,123975,276972071
2020-04-28,11479399,269251134,0,9500,122265,269373399
2020-04-29,7064927,268034353,0,9500,124450,268158803
2020-04-30,9429592,261893319,0,9500,129105,262022424
2020-05-06,19459416,270125496,0,9500,132145,270257641
2020-05-07,17061379,270539628,0,9500,130435,270670063
2020-05-08,12995358,267274683,0,9500,132145,267406828
2020-05-11,15519797,268198796,0,9500,129960,268328756
2020-05-12,13478481,268034908,0,9500,130910,268165818
2020-05-13,7540710,266727023,0,9500,130245,266857268
2020-05-14,21504488,269033731,15000,24500,339080,269372811
2020-05-15,45092284,285123628,1400,25900,379435,285503063
2020-05-18,31306909,280074082,6800,32700,472842,280546924
2020-05-19,29527390,280381631,0,21400,317148,280698779
2020-05-20,19752679,277242449,0,20000,288600,277531049
2020-05-21,16395667,277249718,0,5000,69050,277318768
2020-05-22,15655725,273969900,8800,13800,181608,274151508
2020-05-25,10961799,277173156,0,5000,64800,277237956
2020-05-26,11864173,277629191,0,5000,67000,277696191
2020-05-27,11101326,278883037,0,5000,65900,278948937
2020-05-28,10225418,276141172,0,5000,66000,276207172
2020-05-29,5433391,273493234,0,5000,65450,273558684
2020-06-01,24885516,282028911,2000,7000,96600,282125511
2020-06-02,19437948,281050988,1000,8000,113520,281164508
2020-06-03,19165574,281546817,0,8000,113360,281660177
2020-06-04,8158289,270617405,0,8000,111760,270729165
2020-06-05,15198534,272764868,0,7000,97440,272862308
2020-06-08,15745331,263558803,0,7000,97650,263656453
2020-06-09,8454219,260923208,0,7000,97650,261020858
2020-06-10,11435086,263498151,0,7000,95970,263594121
2020-06-11,14889574,266517177,0,5000,68500,266585677
2020-06-12,16523973,270824840,0,5000,68000,270892840
2020-06-15,7703923,269639985,0,5000,67300,269707285
2020-06-16,19049352,273547427,0,3900,54756,273602183
2020-06-17,21173322,274117263,200,4100,57851,274175114
2020-06-18,17566435,271797306,0,4100,57810,271855116
2020-06-19,26166972,254617832,0,4100,57687,254675519
2020-06-22,25347138,254228749,500,4600,65734,254294483
2020-06-23,19455216,260417617,0,4600,63940,260481557
2020-06-24,13557766,253238510,0,4600,64078,253302588
2020-06-29,18221376,257680599,700,4600,63020,257743619
2020-06-30,29585931,254234920,300,4900,70070,254304990
2020-07-01,13852726,244611332,0,3900,55731,244667063
2020-07-02,36430700,261206655,0,3900,56589,261263244
2020-07-03,27378509,258471734,0,3900,57135,258528869
2020-07-06,59002605,274115971,0,3900,59202,274175173
2020-07-07,57548266,276034363,0,3900,60333,276094696
2020-07-08,58953648,301417766,0,3900,60489,301478255
2020-07-09,68443790,316166497,0,3900,61308,316227805
2020-07-10,42828341,323145212,0,3900,60060,323205272
2020-07-13,49415139,318664690,0,3900,62049,318726739
2020-07-14,52584195,324106976,0,3900,60723,324167699
2020-07-15,49286938,325274806,0,3900,58695,325333501
2020-07-16,33791078,325628143,0,3900,56121,325684264
2020-07-17,30707517,335566496,0,3900,56043,335622539
2020-07-20,18817084,336031380,0,3900,57720,336089100
2020-07-21,10781200,333607694,0,3900,57720,333665414
2020-07-22,17231772,335172814,0,3900,58110,335230924
2020-07-23,14246647,332159662,300,4200,61572,332221234
2020-07-24,16581772,330501269,2400,6300,88452,330589721
2020-07-27,13450333,338271245,0,3900,53079,338324324
2020-07-28,8737521,339526605,0,3900,53625,339580230
2020-07-29,12458216,335154269,0,3900,55770,335210039
2020-07-30,8096046,335792321,0,3900,55341,335847662
2020-07-31,9312816,334378546,0,3900,56082,334434628
2020-08-03,15389518,334555228,0,3900,57798,334613026
2020-08-04,30335974,337300919,10600,14500,220110,337521029
2020-08-05,22884600,340665783,0,3900,58812,340724595
2020-08-06,15972340,336560367,0,3900,59358,336619725
2020-08-07,34643848,331515152,0,3900,58734,331573886
2020-08-10,43998007,342302276,1200,5100,80070,342382346
2020-08-11,60537350,363256288,26600,30500,458110,363714398
2020-08-12,28889456,354459410,0,3900,60294,354519704
2020-08-13,34497417,363072596,0,3900,59514,363132110
2020-08-14,15589099,360848182,0,3900,59748,360907930
2020-08-17,22882331,345637599,0,3900,61152,345698751
2020-08-18,42152677,355094762,1900,5800,93902,355188664
2020-08-19,39579346,361798548,3000,8300,130476,361929024
2020-08-20,26360688,361948558,0,5300,78175,362026733
2020-08-21,22202713,365385526,27800,33100,497824,365883350
2020-08-24,17665213,356090153,0,5300,79606,356169759
2020-08-25,14076512,357792885,0,5300,78228,357871113
2020-08-26,6947811,356335842,0,5300,75366,356411208
2020-08-27,7692886,352133052,0,5300,76055,352209107
2020-08-28,10973185,353190150,0,5300,76850,353267000
2020-08-31,10636611,347584784,0,5300,76426,347661210
2020-09-01,7326483,343429015,9000,13300,193515,343622530
2020-09-02,15174317,347367063,0,13300,192318,347559381
2020-09-03,8428742,348842168,0,13300,190988,349033156
2020-09-04,5608480,343406938,0,4100,59491,343466429
2020-09-07,9938403,344390481,0,4100,59491,344449972
2020-09-08,7206525,343506533,0,3900,57291,343563824
2020-09-09,8050138,337960210,7900,11800,171218,338131428
2020-09-10,11713700,341428201,3000,13900,200021,341628222
2020-09-11,12830987,342591415,0,3900,57369,342648784
2020-09-14,8155879,332488810,7000,10900,164263,332653073
2020-09-15,11373499,338601746,3700,7600,113088,338714834
2020-09-16,11320967,341276865,11300,18900,280665,341557530
2020-09-17,15507342,346717853,6000,24900,373749,347091602
2020-09-18,13527628,348156261,0,24900,374994,348531255
2020-09-21,10413656,347415746,0,24900,369267,347785013
2020-09-22,13379858,348092025,0,7600,109516,348201541
2020-09-23,5720510,346154867,6000,13600,195704,346350571
2020-09-24,6061437,345747796,0,10600,147128,345894924
2020-09-25,3323002,343690077,3000,13200,182688,343872765
2020-09-28,1866679,341307377,0,13200,180840,341488217
2020-09-29,3589131,341773494,0,10600,145962,341919456
2020-09-30,4065653,341976386,0,10200,141678,342118064
2020-10-09,4731744,339284402,0,9900,139887,339424289
2020-10-12,8599967,340453918,0,9900,142164,340596082
2020-10-13,7517727,342407347,0,9900,140778,342548125
2020-10-14,10583568,345219425,0,9500,133950,345353375
2020-10-15,2656464,344939232,0,9500,132145,345071377
2020-10-16,3520168,343575864,0,9500,130910,343706774
2020-10-19,4792879,344838636,0,9500,131575,344970211
2020-10-20,3197998,344554581,0,9500,133570,344688151
2020-10-21,3883949,345050126,0,9500,131290,345181416
2020-10-22,3540816,345777953,0,9500,130815,345908768
2020-10-23,2906088,344891098,0,9500,126635,345017733
2020-10-26,6417724,344959362,10400,19900,258899,345218261
2020-10-27,4823780,345517848,0,19900,259098,345776946
2020-10-28,5267103,344642340,0,19900,264670,344907010
2020-10-29,5273194,343298900,0,13900,182507,343481407
2020-10-30,10803055,346855872,6000,19900,260690,347116562
2020-11-02,5658437,344637096,0,19900,254322,344891418
2020-11-03,4388183,343177205,0,19900,259496,343436701
2020-11-04,4646220,341114082,3000,22900,296784,341410866
2020-11-05,7939435,338163627,3000,22900,307547,338471174
2020-11-06,6507867,335700791,0,22500,303300,336004091
2020-11-09,15805653,337546511,14800,31300,435696,337982207
2020-11-10,5325225,329221786,9000,25500,352665,329574451
2020-11-11,5804978,330701255,0,25500,344505,331045760
2020-11-12,3533060,331661245,28200,53700,720654,332381899
2020-11-13,3579263,332394466,0,53700,724950,333119416
2020-11-16,2789031,332609983,400,54100,730350,333340333
2020-11-17,7151293,333497069,0,53700,714210,334211279
2020-11-18,9367452,338491164,0,53700,729783,339220947
2020-11-19,3782161,339107948,300,54000,736020,339843968
2020-11-20,2912390,339079381,0,53700,724413,339803794
2020-11-23,6655495,338591875,0,53700,718506,339310381
2020-11-24,4240251,340136755,0,52300,698728,340835483
2020-11-25,4775907,336536395,1400,53700,725487,337261882
2020-11-26,8742428,337707786,0,53700,732468,338440254
2020-11-27,8152753,340875552,0,53700,718506,341594058
2020-11-30,8595929,337787626,0,47700,632025,338419651
2020-12-01,8738629,332831353,0,47700,650628,333481981
2020-12-02,17534429,336196438,6400,54100,756318,336952756
2020-12-03,20043385,337255143,11800,65900,923259,338178402
2020-12-04,12037413,337732606,0,65900,931826,338664432
2020-12-07,10008166,340179129,0,65900,929849,341108978
2020-12-08,4847003,337921462,0,65900,930508,338851970
2020-12-09,9850631,340259110,0,65500,891455,341150565
2020-12-10,3840502,339667124,400,65900,884378,340551502
2020-12-11,4315088,341413179,0,65500,877700,342290879
2020-12-14,4365832,341813767,0,65500,884250,342698017
2020-12-15,2481418,342412532,0,65500,882285,343294817
2020-12-16,7614376,346443762,400,65900,875811,347319573
2020-12-17,5393134,346523688,0,65900,881742,347405430
2020-12-18,4996482,347732920,0,65500,865255,348598175
2020-12-21,6748732,349387817,0,61000,809470,350197287
2020-12-22,4796625,349658827,0,59500,781830,350440657
2020-12-23,5352505,352415465,0,53500,706200,353121665
2020-12-24,2704230,351603196,6000,59500,778260,352381456
2020-12-25,7057758,354504731,0,59500,769930,355274661
2020-12-28,7435320,356889717,313000,372500,4652525,361542242
2020-12-29,3476429,356806829,313000,685500,8651010,365457839
2020-12-30,4306687,353238289,0,685500,8513910,361752199
2020-12-31,8726668,356214786,313000,992500,12525350,368740136
2021-01-04,5439086,356760942,6000,998500,12670965,369431907
2021-01-05,6308408,353428415,0,998500,12870665,366299080
2021-01-06,6632338,352531041,27800,1026300,12839013,365370054
2021-01-07,11433362,354149000,0,998500,11982000,366131000
2021-01-08,5165446,351278769,312901,1311401,15933522,367212291
2021-01-11,5044248,349335477,0,1311401,15697470,365032947
2021-01-12,7111300,349732062,0,1305401,15429840,365161902
2021-01-13,9174836,351692145,6000,1311401,15343392,367035537
2021-01-14,5297914,351706559,0,1311401,15789268,367495827
2021-01-15,2501637,349575219,0,1305401,15703974,365279193
2021-01-18,4680900,349035139,0,1305401,15965054,365000193
2021-01-19,7045108,352165284,6000,1311401,15894180,368059464
2021-01-20,3932874,349713918,0,1311401,15776154,365490072
2021-01-21,1442073,343542444,0,1311401,15802382,359344826
2021-01-22,10291788,348355626,0,1311401,15985978,364341604
2021-01-25,6409563,349739530,0,1311401,15435190,365174720
2021-01-26,4857930,350107616,0,1307201,15398828,365506444
2021-01-27,2250071,349337431,0,1307201,15503404,364840835
2021-01-28,3651466,348621821,32000,1337401,15848202,364470023
2021-01-29,1823644,347498197,1800,1311401,15212252,362710449
2021-02-01,1644421,346208817,13600,1325001,15476012,361684829
2021-02-02,2551111,342974388,0,1313001,15217682,358192070
2021-02-03,2935963,342379926,0,1313001,15270202,357650128
2021-02-04,1330013,335233451,27800,1337901,15118281,350351732
2021-02-05,731859,330000106,0,1305101,14695437,344695543
2021-02-08,1430990,318824322,4400,1307901,14517701,333342023
2021-02-09,1931567,316019573,1600,1309501,14928311,330947884
2021-02-10,18634512,311951177,636600,1938501,23494632,335445809
2021-02-18,32702436,327565107,23700,1961801,25091435,352656542
2021-02-19,19933391,333202176,400,1940201,24815171,358017347
2021-02-22,11707095,329532025,6000,1944901,24466855,353998880
2021-02-23,7506687,332690353,34600,1972701,24441765,357132118
2021-02-24,4226122,333509119,6000,1957701,24295069,357804188
2021-02-25,5323949,328578153,0,1957701,23707759,352285912
2021-02-26,3130351,325599303,400,1952001,23716812,349316115
2021-03-01,6967011,327819703,8800,1958301,24576678,352396381
2021-03-02,4242257,323187540,400,1958001,24279212,347466752
2021-03-03,6119725,323279046,400,1952101,24342699,347621745
2021-03-04,5753400,324333707,6000,1956701,24028288,348361995
2021-03-05,3234322,320258070,0,1950301,23871684,344129754
2021-03-08,5689043,316215645,6000,1956301,23416923,339632568
2021-03-09,4420917,314855421,0,1952201,23035972,337891393
2021-03-10,2497079,315809520,4100,1956101,22925504,338735024
2021-03-11,3324255,316526771,0,1950301,23208582,339735353
2021-03-12,6228340,319537241,6000,1956301,23221293,342758534
2021-03-15,2079318,318789125,0,1956301,22751781,341540906
2021-03-16,1638905,318490760,9500,1957401,23136480,341627240
2021-03-17,1890978,317280111,6000,1957401,23214776,340494887
2021-03-18,1968648,316245601,0,1953901,22860642,339106243
2021-03-19,1848941,314801383,0,1953901,22899720,337701103
2021-03-22,3966788,317378360,0,1953901,22997415,340375775
2021-03-23,1237658,315043794,0,1953901,22802025,337845819
2021-03-24,6412185,318322556,8000,1956401,22596432,340918988
2021-03-25,3798330,319902260,1600,1949501,22497242,342399502
2021-03-26,2896449,320399225,0,1947901,22556694,342955919
2021-03-29,2252793,321434814,6800,1954701,22283591,343718405
2021-03-30,3704615,322900953,0,1954101,22159505,345060458
2021-03-31,1799575,322308876,0,1954101,22179046,344487922
2021-04-01,5584196,318015768,1100,1955201,23130028,341145796
2021-04-02,7983476,313177593,0,1955001,23596862,336774455
2021-04-06,4605941,311228896,32100,1987101,23606760,334835656
2021-04-07,3389665,312331699,0,1986001,23474532,335806231
2021-04-08,3100345,312908448,10000,1996001,23453012,336361460
2021-04-09,4600853,311467299,100,1996101,23074928,334542227
2021-04-12,15073863,316701063,3500,1999501,23354172,340055235
2021-04-13,3471737,316848691,0,1996001,23373172,340221863
2021-04-14,2182995,316337566,10000,2006001,23369912,339707478
2021-04-15,2075540,314299110,100,2006101,23351016,337650126
2021-04-16,1951536,311661527,0,2006001,23650752,335312279
2021-04-19,16164049,319908016,1100,2007101,24707413,344615429
2021-04-20,10329091,322661602,0,2000001,24000012,346661614
2021-04-21,5250845,322689874,0,2000001,24080012,346769886
2021-04-22,4803491,323550744,10200,2010201,24323432,347874176
2021-04-23,5861481,323638376,5800,2016001,24252492,347890868
2021-04-26,7928246,319133861,10000,2026001,24149932,343283793
2021-04-27,8333067,320347632,962200,2988201,34752778,355100410
2021-04-28,5448142,323323449,605400,3570801,41599832,364923281
2021-04-29,10239242,324090631,440900,4011201,46048587,370139218
2021-04-30,4510045,320267339,0,3990401,45650187,365917526
2021-05-06,17572118,333378280,100,3817601,44627756,378006036
2021-05-07,10555365,341065943,9400,2038601,23607000,364672943
2021-05-10,14418910,352696884,0,1541401,17864838,370561722
2021-05-11,3345659,354632679,0,1535401,17733882,372366561
2021-05-12,3303749,354860829,0,1205401,13946490,368807319
2021-05-13,6481862,352491489,6000,139701,1600973,354092462
2021-05-14,5381332,348730706,200,26200,302610,349033316
2021-05-17,6994782,347887291,0,26000,300040,348187331
2021-05-18,9962734,343806537,0,26000,294580,344101117
2021-05-19,4841088,343269725,27800,53800,604174,343873899
2021-05-20,3862189,343685520,0,26000,289640,343975160
2021-05-21,1634981,340953787,800,26800,299088,341252875
2021-05-24,2795501,335824255,0,26000,291460,336115715
2021-05-25,4987689,330630295,25000,51000,573240,331203535
2021-05-26,6220887,324610207,900,20900,235125,324845332
2021-05-27,17418717,333173985,0,20000,233600,333407585
2021-05-28,21779201,336465760,7600,27600,330372,336796132
2021-05-31,20126194,339920007,11000,38600,475166,340395173
2021-06-01,15291970,339497157,900,28500,349980,339847137
2021-06-02,6983352,334403535,0,28500,350835,334754370
2021-06-03,10277848,328616100,1000,22700,282615,328898715
2021-06-04,3087398,322730701,800,11900,147203,322877904
2021-06-07,10796493,325841100,13600,25000,312250,326153350
2021-06-08,12657967,318895707,7300,29500,371405,319267112
2021-06-09,8146518,322717371,0,28200,348552,323065923
2021-06-10,6981646,322650413,1000,23300,292182,322942595
2021-06-11,11499341,326292098,8300,30100,369327,326661425
2021-06-15,8203637,329464900,100,29700,298188,329763088
2021-06-16,7933167,327474498,200,28640,289550,327764048
2021-06-17,11352981,325636519,20100,31540,330855,325967374
2021-06-18,19273659,326959561,19300,37540,394921,327354482
2021-06-21,9813609,327245329,3000,34240,358835,327604164
2021-06-22,11291729,333195839,8200,39440,407810,333603649
2021-06-23,8306421,333363982,4000,36240,379070,333743052
2021-06-24,16181575,336779140,13200,47440,502390,337281530
2021-06-25,13339734,339462771,0,37240,386924,339849695
2021-06-28,12465175,335392496,3000,40240,425337,335817833
2021-06-29,8069197,331897811,5300,42540,440714,332338525
2021-06-30,5030409,325979576,0,24340,256787,326236363
2021-07-01,6814267,322655747,14800,37440,382637,323038384
2021-07-02,5219908,317577242,11700,46140,471089,318048331
2021-07-05,3654302,317135616,0,19600,204428,317340044
2021-07-06,8982133,320820321,7700,24200,253616,321073937
2021-07-07,9796895,316502613,900,25100,263550,316766163
2021-07-08,13790019,316489363,2600,27300,288834,316778197
2021-07-09,29797491,323792881,4900,25000,276500,324069381
2021-07-12,27764621,334950830,10300,35300,389006,335339836
2021-07-13,15103396,337036270,300,28000,309120,337345390
2021-07-14,21078613,339496240,20000,48000,523680,340019920
2021-07-15,9251621,335551100,0,26600,286482,335837582
2021-07-16,6998949,332631964,900,24500,259945,332891909
2021-07-19,6575803,333233503,7200,28700,305942,333539445
2021-07-20,16082532,342263131,2000,28800,311328,342574459
2021-07-21,15914067,339016597,3500,25100,278108,339294705
2021-07-22,21812179,343131127,22500,47500,535800,343666927
2021-07-23,11410824,336260382,1000,32600,363164,336623546
2021-07-26,10490600,334297040,1000,32600,367402,334664442
2021-07-27,52650490,327063160,15000,44600,537430,327600590
2021-07-28,42378822,343757880,800,29500,331580,344089460
2021-07-29,31843070,334938447,16700,28200,340374,335278821
2021-07-30,36801720,349486592,19900,48100,574314,350060906
2021-08-02,38101461,371093072,0,21500,258000,371351072
2021-08-03,30749615,381231795,7200,28600,328900,381560695
2021-08-04,18092649,378510351,3200,31800,373650,378884001
2021-08-05,28666822,380229534,11400,36000,430560,380660094
2021-08-06,19626539,379942002,10900,45300,545865,380487867
2021-08-09,15165153,386995047,6200,30900,366165,387361212
2021-08-10,15246037,386335428,7000,35900,430800,386766228
2021-08-11,9535004,385275859,7700,41000,489950,385765809
2021-08-12,13395779,379124164,1000,37300,448719,379572883
2021-08-13,13751348,380653169,8700,46000,548780,381201949
2021-08-16,32138109,393719609,0,34000,418880,394138489
2021-08-17,33675567,397255864,14000,42900,492063,397747927
2021-08-18,15828312,397720411,1600,37700,423371,398143782
2021-08-19,13308647,400665666,0,34300,382445,401048111
2021-08-20,7715899,399976281,0,34300,384503,400360784
2021-08-23,7098617,391463992,0,19500,226785,391690777
2021-08-24,9549590,390757456,7200,26700,311589,391069045
2021-08-25,14380030,389876959,3900,30600,349758,390226717
2021-08-26,14571355,398455614,0,16700,189712,398645326
2021-08-27,5951950,397767807,2400,11900,134470,397902277
2021-08-30,12530374,399577693,7200,19100,212965,399790658
2021-08-31,12800370,389198323,0,16800,180264,389378587
2021-09-01,8691190,386383614,0,11800,123900,386507514
2021-09-02,6504418,384336372,10000,21800,228028,384564400
2021-09-03,19212089,397244031,0,10200,107508,397351539
2021-09-06,18631813,400067430,13500,16500,182490,400249920
2021-09-07,7411275,395507419,0,3800,41686,395549105
2021-09-08,7456466,395406345,500,4300,47601,395453946
2021-09-09,8812463,397228451,9900,14200,156058,397384509
2021-09-10,5119837,394379086,0,11500,126155,394505241
2021-09-13,5514020,390211851,2700,7000,76160,390288011
2021-09-14,6368691,387659935,7200,14200,151372,387811307
2021-09-15,2834671,386064973,0,11500,122935,386187908
2021-09-16,7666116,388163681,10000,20700,212382,388376063
2021-09-17,10278512,388367914,0,13500,139725,388507639
2021-09-22,5752065,388040717,0,13500,138375,388179092
2021-09-23,8024529,387119432,0,3500,35945,387155377
2021-09-24,7984041,381300671,8200,11700,117468,381418139
2021-09-27,6421101,382040249,100,4600,44390,382084639
2021-09-28,1702752,378305433,16100,20700,199962,378505395
2021-09-29,3811709,377341565,400,13800,129168,377470733
2021-09-30,2215473,375834863,0,6700,63583,375898446
2021-10-08,3496308,376367931,0,6600,63888,376431819
2021-10-11,2958189,376661925,0,6200,60202,376722127
2021-10-12,3097028,377134285,7200,13400,127300,377261585
2021-10-13,2926076,378483456,0,6200,59334,378542790
2021-10-14,2566525,378618992,0,6200,59086,378678078
2021-10-15,3330889,376274083,900,7000,67270,376341353
2021-10-18,3442221,376313535,7200,13700,130424,376443959
2021-10-19,2458786,373565844,0,6500,62660,373628504
2021-10-20,2085313,373457506,7700,14200,134900,373592406
2021-10-21,4241321,373305421,0,14200,131918,373437339
2021-10-22,3440556,374353534,2600,9600,90240,374443774
2021-10-25,3899925,375427034,7200,16800,158760,375585794
2021-10-26,2412027,370794586,0,16800,160944,370955530
2021-10-27,9486357,376952013,5000,16600,153052,377105065
2021-10-28,14679684,372701362,5200,19800,169092,372870454
2021-10-29,2356592,365360307,0,13100,115935,365476242
2021-11-01,4316580,361871526,19500,28000,266280,362137806
2021-11-02,9820026,364825358,15300,30800,290136,365115494
2021-11-03,6481361,367366199,0,8000,75040,367441239
2021-11-04,5338911,365043150,7200,15200,146528,365189678
2021-11-05,5853996,367070826,0,7100,69012,367139838
2021-11-08,5515981,366315811,7200,14300,139854,366455665
2021-11-09,4831650,362059483,0,12300,118941,362178424
2021-11-10,5876586,365497399,0,7100,69935,365567334
2021-11-11,11598391,370067087,5000,12100,121726,370188813
2021-11-12,5572320,368271413,0,6500,66105,368337518
2021-11-15,5828732,369275925,13700,20200,204424,369480349
2021-11-16,5804120,370363696,1400,21600,217080,370580776
2021-11-17,8015399,365740302,0,21600,218808,365959110
2021-11-18,5466826,368460291,9300,30900,306837,368767128
2021-11-19,8816062,364473242,500,24200,245146,364718388
2021-11-22,22792355,369418558,1200,21900,229950,369648508
2021-11-23,14554205,369419008,800,22700,240847,369659855
2021-11-24,6973319,366554342,5600,27800,292178,366846520
2021-11-25,9712464,365650681,6100,33100,351853,366002534
2021-11-26,18703001,365431196,1200,29800,309324,365740520
2021-11-29,8422061,362714317,3500,12600,131670,362845987
2021-11-30,6094133,360588433,21200,32300,337535,360925968
2021-12-01,6730762,361173303,2400,34700,366779,361540082
2021-12-02,22277829,373192181,8900,43600,454748,373646929
2021-12-03,16482372,377543908,0,26900,280298,377824206
2021-12-06,7290964,374984801,0,26700,271005,375255806
2021-12-07,21044533,379298971,22000,47700,466983,379765954
2021-12-08,6641622,371194737,14400,47300,481514,371676251
2021-12-09,8620266,371417796,500,27200,275536,371693332
2021-12-10,6483782,371954675,0,26200,259642,372214317
2021-12-13,14634759,379772140,0,26200,258070,380030210
2021-12-14,7240086,374773053,7200,31800,316728,375089781
2021-12-15,9344425,373516922,0,31800,313548,373830470
2021-12-16,11953327,379170383,0,24600,243786,379414169
2021-12-17,12140982,378738981,25700,50300,485395,379224376
2021-12-20,6212977,376722556,0,41400,391230,377113786
2021-12-21,4731051,374861958,0,38100,364617,375226575
2021-12-22,6517613,372386218,7200,45300,437145,372823363
2021-12-23,5562956,364789702,0,38100,370332,365160034
2021-12-24,7657527,361661269,0,38100,366903,362028172
2021-12-27,6819270,363728883,1000,39100,374187,364103070
2021-12-28,23870024,361375127,33400,71000,731300,362106427
2021-12-29,26938362,358770600,1000,41300,433237,359203837
2021-12-30,14271687,360301114,1900,36000,370800,360671914
2021-12-31,13673968,354147692,7200,41300,425390,354573082
2022-01-04,16979649,360630383,0,41300,424151,361054534
2022-01-05,11948903,354824791,0,41300,412174,355236965
2022-01-06,9196503,354026829,0,41300,412587,354439416
2022-01-07,13513554,355914755,0,20400,197676,356112431
2022-01-10,6195735,356736409,0,20400,198288,356934697
2022-01-11,6055036,358222549,900,21300,205332,358427881
2022-01-12,6616910,355162516,6300,27600,271584,355434100
2022-01-13,7520415,355660541,0,18000,174780,355835321
2022-01-14,7397604,357432225,7200,25200,242424,357674649
2022-01-17,14188218,357973526,3500,21900,218343,358191869
2022-01-18,9144261,361721698,9200,27200,266832,361988530
2022-01-19,5815776,362557774,0,22800,222072,362779846
2022-01-20,12408768,367876690,4800,27600,262200,368138890
2022-01-21,7989006,370212268,0,27600,259440,370471708
2022-01-24,3965693,371928751,1800,25600,238592,372167343
2022-01-25,3995336,368279289,3800,24200,214896,368494185
2022-01-26,8378586,369875067,0,24200,217800,370092867
2022-01-27,12493304,372815247,31100,55300,496041,373311288
2022-01-28,4658132,371407347,500,48600,440802,371848149
2022-02-07,5091554,372571505,7200,28200,257184,372828689
2022-02-08,15274973,384749653,0,28200,263388,385013041
2022-02-09,2921130,384803988,9000,34900,326315,385130303
2022-02-10,3257466,385195092,3200,38100,356235,385551327
2022-02-11,6527592,382326251,18700,55800,507780,382834031
2022-02-14,1656388,380986373,0,37100,335013,381321386
2022-02-15,3160158,378049024,0,29900,270296,378319320
2022-02-16,4731491,375993979,25800,55700,517453,376511432
2022-02-17,5996702,378581451,0,47000,428640,379010091
2022-02-18,3684507,380131504,0,39800,362578,380494082
2022-02-21,16965615,385483768,9700,49500,465795,385949563
2022-02-22,7766277,382207768,7200,47000,431930,382639698
2022-02-23,10219736,382864745,0,41600,388544,383253289
2022-02-24,8431667,382935581,5400,47000,428170,383363751
2022-02-25,2813593,383229796,0,39800,366558,383596354
2022-02-28,3105614,383516267,5400,45200,413580,383929847
2022-03-01,8540434,386751429,1800,46500,428265,387179694
2022-03-02,7494101,380809867,500,47000,429580,381239447
2022-03-03,2368497,377555610,0,47000,427230,377982840
2022-03-04,5280464,378935180,11400,58400,526184,379461364
2022-03-07,6485985,380530987,0,47000,409840,380940827
2022-03-08,3039374,379482629,0,39300,334050,379816679
2022-03-09,7670217,380539063,7200,44000,359480,380898543
2022-03-10,6574542,380054703,1100,37900,308127,380362830
2022-03-11,4890985,375963756,7500,45400,370918,376334674
2022-03-14,4744353,378150931,0,45400,356844,378507775
2022-03-15,5711526,375684987,2100,47500,345325,376030312
2022-03-16,8690387,374331835,0,40300,310713,374642548
2022-03-17,5369868,372472675,500,39400,308896,372781571
2022-03-18,5349351,373984492,15100,53600,420760,374405252
2022-03-21,6920323,375903248,700,39000,308880,376212128
2022-03-22,3786125,373780693,4300,41300,324618,374105311
2022-03-23,4359699,374181175,4300,45600,362064,374543239
2022-03-24,3099896,371901143,1500,43000,335400,372236543
2022-03-25,1885866,371554822,1500,30900,239166,371793988
2022-03-28,1336789,371987198,7200,38100,296037,372283235
2022-03-29,4194285,374537732,0,33600,256368,374794100
2022-03-30,2611213,373250281,0,32100,248133,373498414
2022-03-31,1956746,368886462,20100,46200,359436,369245898
2022-04-01,1426693,368250429,6000,31900,246268,368496697
2022-04-06,1825537,366584937,0,25900,200984,366785921
2022-04-07,3774407,360122316,18600,44500,327075,360449391
2022-04-08,1773406,359295580,3200,39000,285090,359580670
2022-04-11,1578582,353698157,1000,30500,215025,353913182
2022-04-12,2396602,353886947,4000,29700,211167,354098114
2022-04-13,2037763,352977657,6200,35100,244998,353222655
2022-04-14,886448,352311947,0,35100,246051,352557998
2022-04-15,2214767,349604491,700,35800,244872,349849363
2022-04-18,1495235,345082562,0,35800,244514,345327076
2022-04-19,833643,344312351,0,25600,175360,344487711
2022-04-20,2668196,345333881,7200,32800,222712,345556593
2022-04-21,1311239,342359605,6000,31600,206980,342566585
2022-04-22,1950405,339063305,27600,56000,357840,339421145
2022-04-25,1798533,328608435,10300,38700,225621,328834056
2022-04-26,4026000,319002317,100,28700,158998,319161315
2022-04-27,1838153,314466114,30940,56240,330691,314796805
2022-04-28,1126932,313397730,10100,35440,205552,313603282
2022-04-29,2192599,313600950,400,26640,159307,313760257
2022-05-05,2227208,312151350,6000,32240,194085,312345435
2022-05-06,1055547,311379668,34100,61840,364856,311744524
2022-05-09,328705,310521530,3600,31140,188086,310709616
2022-05-10,1158601,309470592,0,27540,166892,309637484
2022-05-11,6957046,309911782,7200,34740,210177,310121959
2022-05-12,2659785,312071615,0,28840,175059,312246674
2022-05-13,1713289,308872160,5900,33440,205322,309077482
2022-05-16,1427378,308947670,2200,30940,189972,309137642
2022-05-17,1177539,309502918,4700,30740,187821,309690739
2022-05-18,1024239,307259511,4900,35640,224176,307483687
2022-05-19,3448558,308223511,0,28440,181163,308404674
2022-05-20,3591043,308325041,30100,58540,383437,308708478
2022-05-23,1552446,307985762,7200,65740,444402,308430164
2022-05-24,4121130,309906062,0,31340,201830,310107892
2022-05-25,1651760,310256236,30000,58540,384608,310640844
2022-05-26,938455,309863117,7200,35540,235630,310098747
2022-05-27,1532192,309974452,0,35540,234209,310208661
2022-05-30,833205,309828938,0,28340,187894,310016832
2022-05-31,4131513,310126641,6800,32740,219031,310345672
2022-06-01,2049448,308673552,2000,34240,231805,308905357
2022-06-02,1858698,305510515,1000,35240,241746,305752261
2022-06-06,10454650,307366802,20400,46340,338282,307705084
2022-06-07,9893582,310692568,9300,30240,213494,310906062
2022-06-08,5170439,311650168,2800,28340,202348,311852516
2022-06-09,3852259,311341221,10600,36340,257287,311598508
2022-06-10,7251792,300530613,32200,61340,477839,301008452
2022-06-13,244245,295122073,0,61340,525684,295647757
2022-06-14,44065982,294009220,7200,67640,598614,294607834
2022-06-15,36204403,301598765,700,44540,355429,301954194
2022-06-16,23043841,296583339,19000,56340,471566,297054905
2022-06-17,21636566,304748056,0,32440,260818,305008874
2022-06-20,19666450,309494331,17800,47940,385438,309879769
2022-06-21,13934424,312525281,2400,41940,322938,312848219
2022-06-22,11770609,313927150,4900,44540,342067,314269217
2022-06-23,14748146,316968913,2300,41540,324427,317293340
2022-06-24,10636481,315595298,19100,58340,453302,316048600
2022-06-27,10528730,317644375,2300,46440,362232,318006607
2022-06-28,18692536,311324246,3500,31140,253480,311577726
2022-06-29,12012601,311832259,39600,69940,544133,312376392
2022-06-30,10803685,313559783,1600,54340,414614,313974397
2022-07-01,6231680,311941047,1400,55740,425296,312366343
2022-07-04,6068764,311002369,0,30140,229968,311232337
2022-07-05,7560535,311813179,8200,35840,268800,312081979
2022-07-06,6040729,312430576,500,28140,207955,312638531
